CCTTCAGCCTCATTTTTTTTTTATACATTATTTCCAGCACTTAATGAAAACACATAGTGCCTCTATGAGTCCATATTGAGTCAAGTGTTCTTAGAGGTTTTCAAATTTTCAAAGCAGGGAAATTTAACTTTGAGCTTATGATTTCAG	CCTTCAGCCTCATTTTTTTTTTATACATTATTTCCAGCACTTAATGAAAACACATAGTGCCTCTATGAGTCCGTATTGAGTCAAGTGTTCTTAGAGGTTTTCAAATTTTCAAAGCAGGGAAATTTAACTTTGAGCTTATGATTTCAG
TTTAAATATTCCAGTTTCATCATATTTCTGTTACAGATTTGGAACTTATTTATTTTTTCTATCCTGGACCTCAGGATAATCAATAATAAACATGGAAGTTATAATCTGGCTTCTTTTACATGTAGTATAATGAGGTATTTCCCCCGT	TTTAAATATTCCAGTTTCATCATATTTCTGTTACAGATTTGGAACTTATTTATTTTTTCTATCCTGGACCTCGGGATAATCAATAATAAACATGGAAGTTATAATCTGGCTTCTTTTACATGTAGTATAATGAGGTATTTCCCCCGT
TCTGTTTCTTAGCATTTCTCTCTCTCCTGCTTTGGAGCAGACTGAAAGGGAAGTGGCATTATTTCATCTGATTTAATGTTCATTTGCAGTTATTTTTGTTATATGTTTCATTTGTATTTCATTTATGCTCTAGTTATGTTAACATTT	TCTGTTTCTTAGCATTTCTCTCTCTCCTGCTTTGGAGCAGACTGAAAGGGAAGTGGCATTATTTCATCTGATGTAATGTTCATTTGCAGTTATTTTTGTTATATGTTTCATTTGTATTTCATTTATGCTCTAGTTATGTTAACATTT
GATCAGCATATACCAAATGGGAAGACTGGAATCATAGTAGGAACTAGATTCTATTTCCCTTTCACTAATTGGAATGAACACTCTAGCTTTGTGACCACCAGTTTTTATTGCTTTTTTAAAAAAGTAGTAGCTACACAATAAAGAAGA	GATCAGCATATACCAAATGGGAAGACTGGAATCATAGTAGGAACTAGATTCTATTTCCCTTTCACTAATTGGGATGAACACTCTAGCTTTGTGACCACCAGTTTTTATTGCTTTTTTAAAAAAGTAGTAGCTACACAATAAAGAAGA
TATTGCGCTGTTTGAAGGTCTCTTTCTTAACCCTACTTATTTTATTTTCACTAAAATTCAAGTTTTTCAAATTAACAACCTAAGGAAACTTTTTAGACATTTGTCCCCTATTCTCTGCCCACCATGAGAGTTTAATACCTCAGATAT	TATTGCGCTGTTTGAAGGTCTCTTTCTTAACCCTACTTATTTTATTTTCACTAAAATTCAAGTTTTTCAAATCAACAACCTAAGGAAACTTTTTAGACATTTGTCCCCTATTCTCTGCCCACCATGAGAGTTTAATACCTCAGATAT
GTATTCTTTTGTAGACATGGGGTTTGGCCATGTTGCCCAGGCCAGTCTGGAATTCCTGGGCTCAAGCAGTTTGCCTGCCTCAGCCTCCCAAAGTGCTGGGATTATAGGCATTGAGTCACTGTGCTTGGCCTATTTTAGTATTTATTA	GTATTCTTTTGTAGACATGGGGTTTGGCCATGTTGCCCAGGCCAGTCTGGAATTCCTGGGCTCAAGCAGTTTACCTGCCTCAGCCTCCCAAAGTGCTGGGATTATAGGCATTGAGTCACTGTGCTTGGCCTATTTTAGTATTTATTA
CTTGCAGAGTCTCTTTAGGAGGCCTACTTTGCATTTGGCATTTAATGAAAGCCGAAGGATCATTTTGTGACATGTGAATTGACCAGACCTCAGTAGCTTTTCCAACTCCTTAATAAATGAATCTAAATATTTTAAAAATCTGGCCAG	CTTGCAGAGTCTCTTTAGGAGGCCTACTTTGCATTTGGCATTTAATGAAAGCCGAAGGATCATTTTGTGACAGGTGAATTGACCAGACCTCAGTAGCTTTTCCAACTCCTTAATAAATGAATCTAAATATTTTAAAAATCTGGCCAG
CAAAATGAACTACTGTATAGACAACTTCAGCCACTTGATTGATTGCAGGGATTTATTCTACTTACTGCAAATCCTGATAAGCAACTGCTTTCCATTATTTGATTCCAATAGTTTGTAATGATAACATTAGTTTGTGTTTGTTCCTCT	CAAAATGAACTACTGTATAGACAACTTCAGCCACTTGATTGATTGCAGGGATTTATTCTACTTACTGCAAATACTGATAAGCAACTGCTTTCCATTATTTGATTCCAATAGTTTGTAATGATAACATTAGTTTGTGTTTGTTCCTCT
CTTTAATTATAAGATCATTTACTGGAGTTCTGATTGTCTTTCTTGCAAAACCACACCCATAATTCATCATCTATGACTTTCAGTTTGGTGGAGCAAGAATTAGAAACCTGTGAAGAAAATCTAAGTTCAAAATCCTTTAAATTTTTT	CTTTAATTATAAGATCATTTACTGGAGTTCTGATTGTCTTTCTTGCAAAACCACACCCATAATTCATCATCTGTGACTTTCAGTTTGGTGGAGCAAGAATTAGAAACCTGTGAAGAAAATCTAAGTTCAAAATCCTTTAAATTTTTT
GCGGGGCTCACATTAAAGAAGAGCATTGTATCTTCCGGAGTGAGAGAAGCAACAGCGGGGAAGGTGAGCATTCCTGGCTGGAGCTTCAGCAACAACATTTTCATTTTATATTATGAGAAATCCTTAAGACTTTGTATTCTCTGTCTA	GCGGGGCTCACATTAAAGAAGAGCATTGTATCTTCCGGAGTGAGAGAAGCAACAGCGGGGAAGGTGAGCATTTCTGGCTGGAGCTTCAGCAACAACATTTTCATTTTATATTATGAGAAATCCTTAAGACTTTGTATTCTCTGTCTA
CTTGAGTAGATTTTGGCCTCAAGACCATGTGACTTATTTTTGGATTCCAGTGGGTTATTTTCACTAAAGAAGGTTGGTTTTTTAAAAAGATTTTAGAAATATTAGAGTTAGATGAAGAGGATTGTTAGAAGATGTTTATCTTATCGA	CTTGAGTAGATTTTGGCCTCAAGACCATGTGACTTATTTTTGGATTCCAGTGGGTTATTTTCACTAAAGAAGTTTGGTTTTTTAAAAAGATTTTAGAAATATTAGAGTTAGATGAAGAGGATTGTTAGAAGATGTTTATCTTATCGA
CTCTCTGTTATTAGAGTTTGATAAACTGAAAGTGTCTGTTGGTTGGCGTATGGTTCTTTAGGATGATTGACAGTGGCAGTACCTGGACTAACGTGACTTTAGCTTCTTTTGGATGATTCCCTCTTGTCTTTCTGACCTTAGGACCTT	CTCTCTGTTATTAGAGTTTGATAAACTGAAAGTGTCTGTTGGTTGGCGTATGGTTCTTTAGGATGATTGACAATGGCAGTACCTGGACTAACGTGACTTTAGCTTCTTTTGGATGATTCCCTCTTGTCTTTCTGACCTTAGGACCTT
TTTGATGCCAAGGTGGAAGGATCACTTGAGGCCAGGAGTTCAAGACCAGCCTGGGCAACATAAGGAGACCCTATCTCTACAAAAAAACTTAAAAATTAGCTGGGTATAGTGGTGTATGCCTGAAGTCCCAACTACTCAGGAGGCTGA	TTTGATGCCAAGGTGGAAGGATCACTTGAGGCCAGGAGTTCAAGACCAGCCTGGGCAACATAAGGAGACCCTGTCTCTACAAAAAAACTTAAAAATTAGCTGGGTATAGTGGTGTATGCCTGAAGTCCCAACTACTCAGGAGGCTGA
GCCAAGAGTTCAAGACGAGCCTGGGCAACATGACAAAAACCCCATCTCCACAAAAAAATACAAAAATTAGTTGGGTGTGGTGGTGTACACCTGTAGTCCCAGCTACTCAGGAAGCTGAGATGGGAGGATCACTTGAGTCCTGGAGGC	GCCAAGAGTTCAAGACGAGCCTGGGCAACATGACAAAAACCCCATCTCCACAAAAAAATACAAAAATTAGTTAGGTGTGGTGGTGTACACCTGTAGTCCCAGCTACTCAGGAAGCTGAGATGGGAGGATCACTTGAGTCCTGGAGGC
TTCTGAAACAAGATGTATCAAAGTGAGGTTCTGGTTGTTGAAACTCCCTATTGTTACTGTAGAGGCAGCTTTTTTCAGCTGAATGTAACTTGTAGTGTTCGGTTTGCTTCCAGTTGTCTGATATCTCTCCAATTGGACGGGATCCCT	TTCTGAAACAAGATGTATCAAAGTGAGGTTCTGGTTGTTGAAACTCCCTATTGTTACTGTAGAGGCAGCTTTCTTCAGCTGAATGTAACTTGTAGTGTTCGGTTTGCTTCCAGTTGTCTGATATCTCTCCAATTGGACGGGATCCCT
AAGGCAGTCCCCATTGCTGTCTCTGTAGTAACTTTCTTGTCTACCTGCATTTTTCTTTCAGACACCAAACACCTTTGCTGTCTGCACAAAGCACCGTGGGGTCCTTTTGCAGGCCCTCAATGACAAAGACATGAACGACTGGTTGTA	AAGGCAGTCCCCATTGCTGTCTCTGTAGTAACTTTCTTGTCTACCTGCATTTTTCTTTCAGACACCAAACACATTTGCTGTCTGCACAAAGCACCGTGGGGTCCTTTTGCAGGCCCTCAATGACAAAGACATGAACGACTGGTTGTA
TGGGAGGCAGAGGTTGCAGTTGGCTGAGGTTGCGCCATTGCACTTCAGCCTGGGTAACAAGAGCGAAACTTCGTCTCAAAAAATATATATATATTTCTTATATAGATGATCAAATAACTTGTTTAGCCAGAGGTTATAATATTAGTG	TGGGAGGCAGAGGTTGCAGTTGGCTGAGGTTGCGCCATTGCACTTCAGCCTGGGTAACAAGAGCGAAACTTCATCTCAAAAAATATATATATATTTCTTATATAGATGATCAAATAACTTGTTTAGCCAGAGGTTATAATATTAGTG
CGATTGTTTTCACCCAGAAGAAACACGATAATGAGACCAACCTTTCCACTGAGAAGGTAGGAGAGTTTCAGTCTCTAGGCTTGAGTTGTGAAGGATGGAGATTTTGAGAAGTCCCTTTTGTTGCCCTCTGCTTTTTGTGGAAGGTTG	CGATTGTTTTCACCCAGAAGAAACACGATAATGAGACCAACCTTTCCACTGAGAAGGTAGGAGAGTTTCAGTTTCTAGGCTTGAGTTGTGAAGGATGGAGATTTTGAGAAGTCCCTTTTGTTGCCCTCTGCTTTTTGTGGAAGGTTG
AATTTAATTTAACAAGCCCTCATCACGAGCAGAGCATGAGCAGGGGCCACTGTCCTGGGTGTTTGGGGAGAAACAGAAGAAGGGAGGGAGGAGCAGCCCTCAGGTTAAAAGCAATGATTTGTTCCAACCAATATTTGAGTACCCACC	AATTTAATTTAACAAGCCCTCATCACGAGCAGAGCATGAGCAGGGGCCACTGTCCTGGGTGTTTGGGGAGAAGCAGAAGAAGGGAGGGAGGAGCAGCCCTCAGGTTAAAAGCAATGATTTGTTCCAACCAATATTTGAGTACCCACC
CACGAGCAGAGCATGAGCAGGGGCCACTGTCCTGGGTGTTTGGGGAGAAACAGAAGAAGGGAGGGAGGAGCAGCCCTCAGGTTAAAAGCAATGATTTGTTCCAACCAATATTTGAGTACCCACCCTGTGCCTGGTGTGCTGCTGGGT	CACGAGCAGAGCATGAGCAGGGGCCACTGTCCTGGGTGTTTGGGGAGAAACAGAAGAAGGGAGGGAGGAGCACCCCTCAGGTTAAAAGCAATGATTTGTTCCAACCAATATTTGAGTACCCACCCTGTGCCTGGTGTGCTGCTGGGT
TAAACAGTACATTGCTGAAACATGTTAGAGCTCTCATTGAGTTTTACTCTTAGGTTTTGATCAAGTCATGGTAAAATGTTAGTTATCATGTATATATGCGGCTGTGGTAGTAATTGATTCTGGAATAAATGAGCACCAATAAAGAAT	TAAACAGTACATTGCTGAAACATGTTAGAGCTCTCATTGAGTTTTACTCTTAGGTTTTGATCAAGTCATGGTGAAATGTTAGTTATCATGTATATATGCGGCTGTGGTAGTAATTGATTCTGGAATAAATGAGCACCAATAAAGAAT
CAGCCTTGACCTTCTGGGCCAAAGCGATCTTACCCCCTCAGCTTCTCAAGTAGCTGGGACAACAGGTGTGTGCCACCACCACCCCTAGATAATTGATTTTTTTGTAGAGATGGAGTTTCCCTATGTTGCCCAGGTTGGTGTTGAACT	CAGCCTTGACCTTCTGGGCCAAAGCGATCTTACCCCCTCAGCTTCTCAAGTAGCTGGGACAACAGGTGTGTGGCACCACCACCCCTAGATAATTGATTTTTTTGTAGAGATGGAGTTTCCCTATGTTGCCCAGGTTGGTGTTGAACT
GCATCACTTAAATGGCTCCAAATTATGACTGTGGTACACATCACTTCACCATTCCTTCATTTTTGTCCTTTCAGGCTATTTCTGGGTTTTGGGTATAATGAATAGTGTCCTGCTTTAATCTTTTTTTTGGGGGGTGCGCGGTGGGGA	GCATCACTTAAATGGCTCCAAATTATGACTGTGGTACACATCACTTCACCATTCCTTCATTTTTGTCCTTTCGGGCTATTTCTGGGTTTTGGGTATAATGAATAGTGTCCTGCTTTAATCTTTTTTTTGGGGGGTGCGCGGTGGGGA
CCGTGTGTACAATGACATTGGCAAGGAAATGCTCTTACACGCCTTTGAGGGATATAATGTCTGTATTTTTGCCTATGGGCAGACTGGTGCTGGAAAATCTTATACAATGATGGGTAAACAAGAAGAAAGCCAGGCTGGCATCATTCC	CCGTGTGTACAATGACATTGGCAAGGAAATGCTCTTACACGCCTTTGAGGGATATAATGTCTGTATTTTTGCGTATGGGCAGACTGGTGCTGGAAAATCTTATACAATGATGGGTAAACAAGAAGAAAGCCAGGCTGGCATCATTCC
TGGTTGACAAGAGCAAAATTCTGTCTCCAAAAAAAAAAAAAAAAGAAGTACTAAAGGAAGTCCTTCAGCCTAAAAGAAAAGGACACTAGAACAATATCTTGAATTCACCAGAAGGCATGGAGCACTAGAATGATGAAGGCAGCTAAA	TGGTTGACAAGAGCAAAATTCTGTCTCCAAAAAAAAAAAAAAAAGAAGTACTAAAGGAAGTCCTTCAGCCTAGAAGAAAAGGACACTAGAACAATATCTTGAATTCACCAGAAGGCATGGAGCACTAGAATGATGAAGGCAGCTAAA
GTAATGAATGCTTCATTACCAAATGCTTTTCTGAAGTACATAGTAAGATCTTTAAAAAGAGCTTTCATGGCCAGGCGCGGTGGCTCACGCTTGTAATCCCAGCACTTTGGGAGGCCGAGGCGGGTGGATCACAAGGTCAGGAGATCA	GTAATGAATGCTTCATTACCAAATGCTTTTCTGAAGTACATAGTAAGATCTTTAAAAAGAGCTTTCATGGCCCGGCGCGGTGGCTCACGCTTGTAATCCCAGCACTTTGGGAGGCCGAGGCGGGTGGATCACAAGGTCAGGAGATCA
CTGTTTTTTAAATCTTGCATTTAATTCCTCTTTGGTTAGAAGTATACTTCTTTGCTTGGATTACCATTTGCATGTGGAGAGATGTTCCTTCTAGAACCATGTCTCCTTGTCACATGATTATGTACAGTGTGAGCTTTATTAATACTC	CTGTTTTTTAAATCTTGCATTTAATTCCTCTTTGGTTAGAAGTATACTTCTTTGCTTGGATTACCATTTGCACGTGGAGAGATGTTCCTTCTAGAACCATGTCTCCTTGTCACATGATTATGTACAGTGTGAGCTTTATTAATACTC
AGCGGTGAGGACTACCTCAGAGGGCATGCCTTGTGTCATCATTGTTCTTATTGCTGAGCTACCGAAACCTAGAATCTGACTCACACAATATGACACTTATTTCCGTTTTCTTGGTAGAGTTTGTGTGGTCATTCATCTTTTAGATCT	AGCGGTGAGGACTACCTCAGAGGGCATGCCTTGTGTCATCATTGTTCTTATTGCTGAGCTACCGAAACCTAGCATCTGACTCACACAATATGACACTTATTTCCGTTTTCTTGGTAGAGTTTGTGTGGTCATTCATCTTTTAGATCT
GTCCTGGATCTCCTACTCAGGACTTTTGTCCTTCTAGGTCTGTGCTTTTAATAGGACTGTCTCCAAAGTTGATGATTTCTTGGCCAATGAGGCAAAGGGAACCAAAGTGGTGGGTGCCCAGTCCCTGAAAGAGATGGTCTCCAAGCT	GTCCTGGATCTCCTACTCAGGACTTTTGTCCTTCTAGGTCTGTGCTTTTAATAGGACTGTCTCCAAAGTTGACGATTTCTTGGCCAATGAGGCAAAGGGAACCAAAGTGGTGGGTGCCCAGTCCCTGAAAGAGATGGTCTCCAAGCT
CCAGGTTGGTTATTCTTTACCTCCTTCGGTTAAAGTCCACCAGGCTTTTGTCCTCAGATCTCTCTCTCCAGAAAAGAGAGACGCCCTAGATGATTTCTTCTAGTTCTGGGGGCTTAAATGTCATTGAGATGGTGATAACTCCCAGAT	CCAGGTTGGTTATTCTTTACCTCCTTCGGTTAAAGTCCACCAGGCTTTTGTCCTCAGATCTCTCTCTCCAGAGAAGAGAGACGCCCTAGATGATTTCTTCTAGTTCTGGGGGCTTAAATGTCATTGAGATGGTGATAACTCCCAGAT
TCCTTTGGACTTGGAAAAAAATACATTTAGGTCTTAGATGTTAAAGCTGCCTTTTAGATTTATGAAGGAAAATTTAGGAAAACAGCCTTGAAACCTCATGGGATTTGGATGGTAACCAAGAGGCAAGGCCTGGAGGTGAGAGTGAGC	TCCTTTGGACTTGGAAAAAAATACATTTAGGTCTTAGATGTTAAAGCTGCCTTTTAGATTTATGAAGGAAAACTTAGGAAAACAGCCTTGAAACCTCATGGGATTTGGATGGTAACCAAGAGGCAAGGCCTGGAGGTGAGAGTGAGC
CAGGCTGGTCTCAAACTCCTGGACTCTCAAGTCATCTGCCTGCCTTGGCCTCACAAAGTGCTGAGGTTACAGGCATGCGCCACCATGCCCGGCCTCGTGTTGCTGTTAAAGTAAACTTTATCTCATATTGTAGTTCAGCCATGCTGT	CAGGCTGGTCTCAAACTCCTGGACTCTCAAGTCATCTGCCTGCCTTGGCCTCACAAAGTGCTGAGGTTACAGACATGCGCCACCATGCCCGGCCTCGTGTTGCTGTTAAAGTAAACTTTATCTCATATTGTAGTTCAGCCATGCTGT
CCCTTGAGCCCACGAGTTCAAGGCTGCAGTGAGCAGTGATCATACTACTGCACTCTGGCCTGGGTAACAGAGAGAGACCCTGTCTCTTAAACAGAAAAAAACAAAAAGATCACTGCAATAAAAGTGAGTGGTAGCAACTTTTTTTTT	CCCTTGAGCCCACGAGTTCAAGGCTGCAGTGAGCAGTGATCATACTACTGCACTCTGGCCTGGGTAACAGAGGGAGACCCTGTCTCTTAAACAGAAAAAAACAAAAAGATCACTGCAATAAAAGTGAGTGGTAGCAACTTTTTTTTT
TGAGGATTGGAATAAGACAGAGCTAGACTCATTCCTGATTGAAATCACAGCCAATATTCTCAAGTTCCAAGACACCGATGGCAAACACCTGCTGCCAAAGATCAGGGACAGCGCGGGGCAGAAGGGCACAGGGAAGTGGACCGCCAT	TGAGGATTGGAATAAGACAGAGCTAGACTCATTCCTGATTGAAATCACAGCCAATATTCTCAAGTTCCAAGATACCGATGGCAAACACCTGCTGCCAAAGATCAGGGACAGCGCGGGGCAGAAGGGCACAGGGAAGTGGACCGCCAT
TTTGGGAAAATTTTCAGAATTGTAGCTTATTACAGCTTATTAGTGGCAGTGTTAGGACTAGATAATGGTACTCCTACCCTCAGCTGATTATAACACATTGTTTCCCTGCATGTACAATTTCGGCAGGAGTAATTTGTGACTTTTAAA	TTTGGGAAAATTTTCAGAATTGTAGCTTATTACAGCTTATTAGTGGCAGTGTTAGGACTAGATAATGGTACTTCTACCCTCAGCTGATTATAACACATTGTTTCCCTGCATGTACAATTTCGGCAGGAGTAATTTGTGACTTTTAAA
ATCGAGGCTGCAAGATTCATTGTTTTTCTTTCTAGATTTTAAATAATACTTGATTTTGCCAAGATGATCTTAGAACTTTTCAGTGATTCTTTGAGTTGAACAATGGATATAATATATAGTAAACTTATACATTATTACTAAAGTTAT	ATCGAGGCTGCAAGATTCATTGTTTTTCTTTCTAGATTTTAAATAATACTTGATTTTGCCAAGATGATCTTACAACTTTTCAGTGATTCTTTGAGTTGAACAATGGATATAATATATAGTAAACTTATACATTATTACTAAAGTTAT
TGGAGCAGGGATTAACCTGGCTGGCCCCTCGGGGGCGTGCGCCATGGACTGTCCTGACCAACCTACTCTCTCGTTTCCTAGGCTCAGCGGGATTACTTCGGGGCTCACACCTATGAACTCTTGGCCAAACCAGGGCAGTTTATCCAC	TGGAGCAGGGATTAACCTGGCTGGCCCCTCGGGGGCGTGCGCCATGGACTGTCCTGACCAACCTACTCTCTCATTTCCTAGGCTCAGCGGGATTACTTCGGGGCTCACACCTATGAACTCTTGGCCAAACCAGGGCAGTTTATCCAC
CCCCGTCTCTACTAAAAATACAAAAATTAGCTGGGCGTGGTGGCGTACGCCAGTAATCCCAGGTACTCAGGAGGCTGAGGCAGGAGAATTGTTGAATCCGGGAGGCAGAGGTTGCAGTGAGCCGAGGTCGTGCCATTGCACTCCAGC	CCCCGTCTCTACTAAAAATACAAAAATTAGCTGGGCGTGGTGGCGTACGCCAGTAATCCCAGGTACTCAGGAAGCTGAGGCAGGAGAATTGTTGAATCCGGGAGGCAGAGGTTGCAGTGAGCCGAGGTCGTGCCATTGCACTCCAGC
GTACAGTAGCCTGGACGGGTAGGGCATTGAGGTAGAGAGTGACTTTGGTTTTTATGTTATTTATTTATCCTGTTCTCGGGAACACATCGGTTATGGTGTTGTGTAGTTGGAGGTTAGCATTCCTAATTATCTGGAAAAAATATTGGT	GTACAGTAGCCTGGACGGGTAGGGCATTGAGGTAGAGAGTGACTTTGGTTTTTATGTTATTTATTTATCCTGCTCTCGGGAACACATCGGTTATGGTGTTGTGTAGTTGGAGGTTAGCATTCCTAATTATCTGGAAAAAATATTGGT
CCACCTCAGCCTCTCAAGTAGCTGGGATTACCGATGCATGCCACCACACCCAGCTAATTTAAACAAAAATGTTTTTTGGTAGAGAGTGTCTGAATATGTTGCCCAGGCTGGTCTTGAACTTCTGGCCTCAAGCAATTCTTTCACTTT	CCACCTCAGCCTCTCAAGTAGCTGGGATTACCGATGCATGCCACCACACCCAGCTAATTTAAACAAAAATGTCTTTTGGTAGAGAGTGTCTGAATATGTTGCCCAGGCTGGTCTTGAACTTCTGGCCTCAAGCAATTCTTTCACTTT
CCACAATCTTGAACCCCCTGACTTTGCTGTACTCCCCCGTGATGCTGATTACATTCTCGATTCTCTATACCTGATTTATTAATTTTAATGTCCTCCCTCTCCCTACTAGAATGTAAATTCCTCCATGACAAGGAGGTTTGTTTATCT	CCACAATCTTGAACCCCCTGACTTTGCTGTACTCCCCCGTGATGCTGATTACATTCTCGATTCTCTATACCTTATTTATTAATTTTAATGTCCTCCCTCTCCCTACTAGAATGTAAATTCCTCCATGACAAGGAGGTTTGTTTATCT
TTCTCGTATCCTTGCATTCCAGAGACAGCCCTACCAGATCATGGCTACATTCAATTTTCTAGTAATTTATTTATCATTTTAAAGAGATGCTTTTATACAGAATTTGTAATCTGAGAAACTGGCTGGGCAGTGTGACTTCATCTGTCA	TTCTCGTATCCTTGCATTCCAGAGACAGCCCTACCAGATCATGGCTACATTCAATTTTCTAGTAATTTATTTGTCATTTTAAAGAGATGCTTTTATACAGAATTTGTAATCTGAGAAACTGGCTGGGCAGTGTGACTTCATCTGTCA
CGGCAGAAATAGCACCTCCGAACTCCAGCCTGGGCGACAGAACGAGACTCCATCTCAAAAAACAAACAAAAAATAATAATAACAATAAGGAGTTCAAGACAAATCAATAAATTCTCTGGTTTTTCCTCCCAACTCAACATTTCCATC	CGGCAGAAATAGCACCTCCGAACTCCAGCCTGGGCGACAGAACGAGACTCCATCTCAAAAAACAAACAAAAATTAATAATAACAATAAGGAGTTCAAGACAAATCAATAAATTCTCTGGTTTTTCCTCCCAACTCAACATTTCCATC
AAAAAACGAACATGATACCCACCCACATACACTGTATTAAACACCGTATTAAATAATGACAATAGGCTGGGCGTAGTGGCTCATGCATGTAATTCCAGCACTTTGGGAGGCCGAGGCCGAGGTGGGTGGATCCCTTGAGGTTAGGAG	AAAAAACGAACATGATACCCACCCACATACACTGTATTAAACACCGTATTAAATAATGACAATAGGCTGGGCATAGTGGCTCATGCATGTAATTCCAGCACTTTGGGAGGCCGAGGCCGAGGTGGGTGGATCCCTTGAGGTTAGGAG
TAAGGAACTTCTTTAGCCAATAAACATTTTGTGTTTTTCATTTATTATTGAAGATCGATCCAGAAACACACACAGAGAGAGAGATACCTGTTACTTTGTAGTTACGTTTTTTATTAATAAATAGGGACTTTTTAGGTATAAGAAGGA	TAAGGAACTTCTTTAGCCAATAAACATTTTGTGTTTTTCATTTATTATTGAAGATCGATCCAGAAACACACAGAGAGAGAGAGATACCTGTTACTTTGTAGTTACGTTTTTTATTAATAAATAGGGACTTTTTAGGTATAAGAAGGA
TCCTAAGAGTTGCCTAAGAGGAGCGAGCAGCGCCTGTGCCTCGACAGCTGGTGTCTACAGTGTGACCTCTGACCTCTCGGCTAATGTCAGTGAAGGAGACAATTTTCATTAAATCACCAACTTTTAATTTATTTTTCTTTTTTTTGA	TCCTAAGAGTTGCCTAAGAGGAGCGAGCAGCGCCTGTGCCTCGACAGCTGGTGTCTACAGTGTGACCTCTGATCTCTCGGCTAATGTCAGTGAAGGAGACAATTTTCATTAAATCACCAACTTTTAATTTATTTTTCTTTTTTTTGA
GATTACAGGAGTGAGCCACCGTGCCCGGCCCCAAAACTTTTATTGAGTTCCCTTTTTTGCAGCAATAAGAGGCTCTATTTCATAGGGCTGCTGTAAAGATTATAAAAGATCATTAAGGCCAGGCATGGTGGCTCACGCCTATAATCC	GATTACAGGAGTGAGCCACCGTGCCCGGCCCCAAAACTTTTATTGAGTTCCCTTTTTTGCAGCAATAAGAGGTTCTATTTCATAGGGCTGCTGTAAAGATTATAAAAGATCATTAAGGCCAGGCATGGTGGCTCACGCCTATAATCC
GCGTAGTGGCAGGCGCCTGTAGTCCCAGCTACTCGGGAGGCTGAGGTAGGAGAATGGCGTGAACCCGGGAGGCGAAGCTTACAGGGAACCGAGATAGCGCCACTGCATTCCAGCCTGGGTGAAAGAGCAAAACTCCGTATCAAAAAA	GCGTAGTGGCAGGCGCCTGTAGTCCCAGCTACTCGGGAGGCTGAGGTAGGAGAATGGCGTGAACCCGGGAGGTGAAGCTTACAGGGAACCGAGATAGCGCCACTGCATTCCAGCCTGGGTGAAAGAGCAAAACTCCGTATCAAAAAA
CCAGCTACTCGGGAGGCTGAGGCAGGAGAATTACTTGAACCCAAGAGGTGGAGGTTGCAGTGAGCCGAGATCGGGCACTCCAGCCTGGGCGACAGAGCAAGATTCTGTCTCAAAAAAAAAAGAAACAAAGAAAGAAAGTAAAGCAAT	CCAGCTACTCGGGAGGCTGAGGCAGGAGAATTACTTGAACCCAAGAGGTGGAGGTTGCAGTGAGCCGAGATCAGGCACTCCAGCCTGGGCGACAGAGCAAGATTCTGTCTCAAAAAAAAAAGAAACAAAGAAAGAAAGTAAAGCAAT
CTTCTGAATAACAATTTCCTCCTAGCAAGAAGGGACTCAGTAAGATAAGAAGCGCTGCTTGGCTACTTTGCAAATGTCTGGCTTAAGATGGCTGGTTTTTTGTATCTGCCTCTGCATTTAACCTGGTCCATCTCGCGGGTCACATAG	CTTCTGAATAACAATTTCCTCCTAGCAAGAAGGGACTCAGTAAGATAAGAAGCGCTGCTTGGCTACTTTGCATATGTCTGGCTTAAGATGGCTGGTTTTTTGTATCTGCCTCTGCATTTAACCTGGTCCATCTCGCGGGTCACATAG
TAAGTTCTGTTGTGGTTCCTGATAATTGGATTCGTAATTACTTTTCTTTTTTAGATTTTTCCTTTGTTTGGTTATTCTTGAAAAAGATTTTATATTGGATAGAGTGTAGAGTTTTTCCTAACTAGAAAAATTGGTTGTTTTTTTTTT	TAAGTTCTGTTGTGGTTCCTGATAATTGGATTCGTAATTACTTTTCTTTTTTAGATTTTTCCTTTGTTTGGTCATTCTTGAAAAAGATTTTATATTGGATAGAGTGTAGAGTTTTTCCTAACTAGAAAAATTGGTTGTTTTTTTTTT
CAATTAATGTGTAGTCCGAGGTCTCCCTTAAATCTGTCTTTGGTCCCTGTCGGAGCAGTTCTGCTTAGCTCCCTCCCCATTTCTCCACAGTTGCTATTATAAAATCTGGACCCCTTGACTCAAACCTGTCACTGCCCCATGCTTGGC	CAATTAATGTGTAGTCCGAGGTCTCCCTTAAATCTGTCTTTGGTCCCTGTCGGAGCAGTTCTGCTTAGCTCCTTCCCCATTTCTCCACAGTTGCTATTATAAAATCTGGACCCCTTGACTCAAACCTGTCACTGCCCCATGCTTGGC
ACAATTAATGTGTAGTCCGAGGTCTCCCTTAAATCTGTCTTTGGTCCCTGTCGGAGCAGTTCTGCTTAGCTCCCTCCCCATTTCTCCACAGTTGCTATTATAAAATCTGGACCCCTTGACTCAAACCTGTCACTGCCCCATGCTTGG	ACAATTAATGTGTAGTCCGAGGTCTCCCTTAAATCTGTCTTTGGTCCCTGTCGGAGCAGTTCTGCTTAGCTCTCTCCCCATTTCTCCACAGTTGCTATTATAAAATCTGGACCCCTTGACTCAAACCTGTCACTGCCCCATGCTTGG
TTCAGAGAAGCTGATTTTTATTAAAATTGAGAAAGGTATGTACAAATAATGGGACAATAATGCTTGCTTCATTTGATGGCTGCCTGTGTTCTTCAGCACGTTTCCATCCTGTTCTAAGGGAGTTGGAAGTTAAAACCCAGTTTCTGG	TTCAGAGAAGCTGATTTTTATTAAAATTGAGAAAGGTATGTACAAATAATGGGACAATAATGCTTGCTTCATCTGATGGCTGCCTGTGTTCTTCAGCACGTTTCCATCCTGTTCTAAGGGAGTTGGAAGTTAAAACCCAGTTTCTGG
AAGACAAGGCCAGAAGTCAGCTCACAGTTGCAGGAAGATGTTCTCAGTGAATCTGAAAGCCAGTTTATCTCTCCATGGATGTTCTGACATTTGTCTCCTGGTTTCTGTCTTTAGGGCATTTGTTTACCTGAGCAATCTGCTGTATCC	AAGACAAGGCCAGAAGTCAGCTCACAGTTGCAGGAAGATGTTCTCAGTGAATCTGAAAGCCAGTTTATCTCTGCATGGATGTTCTGACATTTGTCTCCTGGTTTCTGTCTTTAGGGCATTTGTTTACCTGAGCAATCTGCTGTATCC
GTGTAACACGGCTACTCAGCGGGAGAGCCAGAGCCAGTCCCAGGGAGTCATTCTGTCTGCAAACCTCTGCCCTGCCTCGCCTTCTGCTGACTCTCAGGTGTCCTCTCTCTCCAGCCTGGGCCCCTACCCTGAGCTCTAGATGCTGAT	GTGTAACACGGCTACTCAGCGGGAGAGCCAGAGCCAGTCCCAGGGAGTCATTCTGTCTGCAAACCTCTGCCCCGCCTCGCCTTCTGCTGACTCTCAGGTGTCCTCTCTCTCCAGCCTGGGCCCCTACCCTGAGCTCTAGATGCTGAT
TTGAGCATGTATTACATGTATTAATACACATAAACCTTTTACATGTTTTGACTCATTGAGTCCTCACAACACCCCTCTTCTGTGAGGTAGGTATTGCTTATTCCCTTTTCACATACTTTCCCAGTGTAACACGGCTACTCAGCGGGA	TTGAGCATGTATTACATGTATTAATACACATAAACCTTTTACATGTTTTGACTCATTGAGTCCTCACAACACTCCTCTTCTGTGAGGTAGGTATTGCTTATTCCCTTTTCACATACTTTCCCAGTGTAACACGGCTACTCAGCGGGA
TTGGCTTCTTTTCCTTGAACCTTTCCAGCTGCTCCATCATGGTCTGTGGACACAGACCTTGGCTATTTCTATATGTTTCTCTGTTCCCCCTTCCATTTTTGTACTGATGATGAAGATAATGATAACTCATATATTGAGCATGTATTA	TTGGCTTCTTTTCCTTGAACCTTTCCAGCTGCTCCATCATGGTCTGTGGACACAGACCTTGGCTATTTCTATGTGTTTCTCTGTTCCCCCTTCCATTTTTGTACTGATGATGAAGATAATGATAACTCATATATTGAGCATGTATTA
TTTAACTGTGCAGTTCTTTTTATTTCAGACTAATAATAGGGAGAGAGAGAGAGAGAACGATAACATCTCACTATCTGTGAAAATAACTAAATATAGCCCATTGTTTTAACAAATCTTTCCAGAGTATCTTCTGTGTGTCGAGACCTG	TTTAACTGTGCAGTTCTTTTTATTTCAGACTAATAATAGGGAGAGAGAGAGAGAGAACGATAACATCTCACTGTCTGTGAAAATAACTAAATATAGCCCATTGTTTTAACAAATCTTTCCAGAGTATCTTCTGTGTGTCGAGACCTG
TGTAATTTAATCTTTACCTTTATACCATAGATTAAGATAATCCCTGTGTTAGCTGAGATGACTGAAGCATAGAGCAATTAAAGTCACTCATCAGGCTGGGCGCAGTGGCTCATACCTGTCCCGGCACTCTGGGAGGCCGAGGCAGGT	TGTAATTTAATCTTTACCTTTATACCATAGATTAAGATAATCCCTGTGTTAGCTGAGATGACTGAAGCATAGCGCAATTAAAGTCACTCATCAGGCTGGGCGCAGTGGCTCATACCTGTCCCGGCACTCTGGGAGGCCGAGGCAGGT
AAAAAAAAAAGAATCGTTGGAAGGGAGATTATGTTCTCTCTTGTCTGGGGCAGCAGTGGTAGTAGCTTTTCAATATTTTTCATAATAAATTTTTCTTTTTTTAATTTAGTTTTTTTTTTAACTTTATTTACAAAGTACTGAATGTCC	AAAAAAAAAAGAATCGTTGGAAGGGAGATTATGTTCTCTCTTGTCTGGGGCAGCAGTGGTAGTAGCTTTTCAGTATTTTTCATAATAAATTTTTCTTTTTTTAATTTAGTTTTTTTTTTAACTTTATTTACAAAGTACTGAATGTCC
GGAAAAGGGCAGCTTGTTCCCATACTTTCCCTGTTCCACAGAGCAGTACTCACCCAAATTGCTTCTGTCTCAATGATACCAAGCACTATTCTTTAATTTCCTTAATGGAGAATGAACTTAAATCTCCCGGTAGCCTTAGCCTGAAAA	GGAAAAGGGCAGCTTGTTCCCATACTTTCCCTGTTCCACAGAGCAGTACTCACCCAAATTGCTTCTGTCTCAGTGATACCAAGCACTATTCTTTAATTTCCTTAATGGAGAATGAACTTAAATCTCCCGGTAGCCTTAGCCTGAAAA
ACAACTCTAATTTTTGGCTGTTTAAAGGCTGAAGTAATAGTCAGCATTAGGATTTTTGTTCTTGTAAAAACAACAGCTCTGAAAGCTGTCTTTTCACATTAGGGAGGGGTGAGGTTGTTAAATAGATACTATATATTAAAAAAATTA	ACAACTCTAATTTTTGGCTGTTTAAAGGCTGAAGTAATAGTCAGCATTAGGATTTTTGTTCTTGTAAAAACAGCAGCTCTGAAAGCTGTCTTTTCACATTAGGGAGGGGTGAGGTTGTTAAATAGATACTATATATTAAAAAAATTA
CCAAACTTAACAGTTATTTTTAAACAACTCACCATTTTCTAACCTTTTGAAAACATTCAACTTAGTTTTCACAGGAACAAAAATTATTTATGTTTTCATATTTCATTGATTTGCCTAATGTTTAATGAAGTTAGATAATAATAATAA	CCAAACTTAACAGTTATTTTTAAACAACTCACCATTTTCTAACCTTTTGAAAACATTCAACTTAGTTTTCACGGGAACAAAAATTATTTATGTTTTCATATTTCATTGATTTGCCTAATGTTTAATGAAGTTAGATAATAATAATAA
ATTGCAGTCTTGCAAAACTGTTCACTTTCTTCTCTGTTTTGTCCTGTGTGGTAATAGAGACAAATTTGGCTATTTGGATAGCTGAGTCTATGAGAAATATTTTATATATATTTTTTAACATTTATCTTTCTCCTGTCAGGGCTGCTT	ATTGCAGTCTTGCAAAACTGTTCACTTTCTTCTCTGTTTTGTCCTGTGTGGTAATAGAGACAAATTTGGCTACTTGGATAGCTGAGTCTATGAGAAATATTTTATATATATTTTTTAACATTTATCTTTCTCCTGTCAGGGCTGCTT
CAAGGGGTGGTGAGTTTTGAATTGGTACTTTTATGTGATATGAAATATTCCTGTGGTTTTCGCTACAATTCTTCTGGTCAGGTTTTTCTATCCTGGCCACATAACTTTTTTTTTTTTTTCTTCCCAAATTCCAATGTGTTATTTTCA	CAAGGGGTGGTGAGTTTTGAATTGGTACTTTTATGTGATATGAAATATTCCTGTGGTTTTCGCTACAATTCTCCTGGTCAGGTTTTTCTATCCTGGCCACATAACTTTTTTTTTTTTTTCTTCCCAAATTCCAATGTGTTATTTTCA
GATAAACTGAAAGTGTCTGTTGGTTGGCGTATGGTTCTTTAGGATGATTGACAGTGGCAGTACCTGGACTAACGTGACTTTAGCTTCTTTTGGATGATTCCCTCTTGTCTTTCTGACCTTAGGACCTTCTACCGCTTTGAGGCTGTG	GATAAACTGAAAGTGTCTGTTGGTTGGCGTATGGTTCTTTAGGATGATTGACAGTGGCAGTACCTGGACTAATGTGACTTTAGCTTCTTTTGGATGATTCCCTCTTGTCTTTCTGACCTTAGGACCTTCTACCGCTTTGAGGCTGTG
ATTAAATTGTTTAGCTATATGAACATAATTTATTAACCAGTGCTATACAAATAACTAGAGATGCAGACAGATATGACGTGAGACCAAAGAGTGAATGACACCTGAGCCTGGCATTCCTCGGAGCTTAAAGAAGAGTTCCTGGTGTCC	ATTAAATTGTTTAGCTATATGAACATAATTTATTAACCAGTGCTATACAAATAACTAGAGATGCAGACAGATGTGACGTGAGACCAAAGAGTGAATGACACCTGAGCCTGGCATTCCTCGGAGCTTAAAGAAGAGTTCCTGGTGTCC
AGGAGAAGTGTCTATGGTGGGGAGCTCATGAGCTGACCTTGAAAGGATGCGCAGGAGGGAGGCAGCAGTGTCGACACCTGCGTGATCAGGAGGGAGGCAGTGGTGTCCTGCGTGATCAGGAGGGAGGCAGCGGTGTCTTGCGTGATC	AGGAGAAGTGTCTATGGTGGGGAGCTCATGAGCTGACCTTGAAAGGATGCGCAGGAGGGAGGCAGCAGTGTCAACACCTGCGTGATCAGGAGGGAGGCAGTGGTGTCCTGCGTGATCAGGAGGGAGGCAGCGGTGTCTTGCGTGATC
CGAATGCATAGGGAGAGGAGATGTGGAGCTTCCATGCCCTCCCCGGGAACTCAGCCCTTCAGGAGCCTCCACGTGGTCAGCTATCCCAAGGCTCCTGGCTGTTGACATTTTATGTTCAGCTTGCACTTCTCTTTCTCTTCTTTAGTG	CGAATGCATAGGGAGAGGAGATGTGGAGCTTCCATGCCCTCCCCGGGAACTCAGCCCTTCAGGAGCCTCCACATGGTCAGCTATCCCAAGGCTCCTGGCTGTTGACATTTTATGTTCAGCTTGCACTTCTCTTTCTCTTCTTTAGTG
GGGGAGGTGGTATGTTATTCTTTGCCAGGGTACAAGGAAACCCTGAGGTTCCTGGTGGCATAAAGTTTTATTGACTTCAACAAAGAGTGAAGTAAACACTTCAGAGAATTTCTGTGTTATTCACTCAATTCTAGTCAGCTTGACCTT	GGGGAGGTGGTATGTTATTCTTTGCCAGGGTACAAGGAAACCCTGAGGTTCCTGGTGGCATAAAGTTTTATTAACTTCAACAAAGAGTGAAGTAAACACTTCAGAGAATTTCTGTGTTATTCACTCAATTCTAGTCAGCTTGACCTT
TATCACTGCATTGTGAAGAGGAGGAAAAGTGAATCACGGAGAGAGAAAGGAAAGGATAGAATCACAGGCTGCGTCTGCACCTGAAAAGTGACCCGCGGAAACTCTATGGCGGATTTTTTTTTTAACTTTCTTCTTCCTGTTAAAACA	TATCACTGCATTGTGAAGAGGAGGAAAAGTGAATCACGGAGAGAGAAAGGAAAGGATAGAATCACAGGCTGCATCTGCACCTGAAAAGTGACCCGCGGAAACTCTATGGCGGATTTTTTTTTTAACTTTCTTCTTCCTGTTAAAACA
GAGAATGGTCATGCCTGTAATCCCAGCACTTTGGGAAGCCAAGGTGGGAGGATCACTGGAGCCCAAGACTTCGAGACCGACCAGCCTGGGCAATGTAGTGAGACCCCATCTCTACAAACAATTAAAAATTAGCTGGGCATGATGGTG	GAGAATGGTCATGCCTGTAATCCCAGCACTTTGGGAAGCCAAGGTGGGAGGATCACTGGAGCCCAAGACTTCAAGACCGACCAGCCTGGGCAATGTAGTGAGACCCCATCTCTACAAACAATTAAAAATTAGCTGGGCATGATGGTG
AGGAGGCAGAGGTTACAGTGAGCCGAGATCATGCCAGTGCACCCCAGCCTGGAGTCTGTCTCAAAAAAAAAATAATAATAATAAATAAATAAAAAGAAGAAGCTGCTGTTTCTTTCTCTTCCTCCCTCTCTCTCTCACCGCCACCCC	AGGAGGCAGAGGTTACAGTGAGCCGAGATCATGCCAGTGCACCCCAGCCTGGAGTCTGTCTCAAAAAAAAAAAAATAATAATAAATAAATAAAAAGAAGAAGCTGCTGTTTCTTTCTCTTCCTCCCTCTCTCTCTCACCGCCACCCC
AAGGCATCATTTCATGCAAGCTCCTCTGAGCCCAGGAGTTCCAGCCTAGCCCAGGCAACAGGGCAAGACCACGTCTCAAAAAAAAAAAAAGTACTCTTTCCACCTAAAATATATTCAGGTCATTTGAGTTCAGTTTGAGTTCAGCTA	AAGGCATCATTTCATGCAAGCTCCTCTGAGCCCAGGAGTTCCAGCCTAGCCCAGGCAACAGGGCAAGACCACATCTCAAAAAAAAAAAAAGTACTCTTTCCACCTAAAATATATTCAGGTCATTTGAGTTCAGTTTGAGTTCAGCTA
AATCTGTATTTTAAAAAAAGAACTGTGCTGTGAAGTTTGACATATTTTAAAGTAGGATGTCTTAGCCGGGCATGGTGTTGCATGCCTGTAGTCCTAGCTACTCAGGAAGTTGAGGCTAGAAGATTGCTCGACCTCAGGAGTTCAAGG	AATCTGTATTTTAAAAAAAGAACTGTGCTGTGAAGTTTGACATATTTTAAAGTAGGATGTCTTAGCCGGGCACGGTGTTGCATGCCTGTAGTCCTAGCTACTCAGGAAGTTGAGGCTAGAAGATTGCTCGACCTCAGGAGTTCAAGG
ATTGGCCGTCATGGGCCAGAACTTAATTCTGAACATGAATGACCACGGCTTTGTGGTAAGCGGCGTGGGCGCGTTGTCTTCTCTCTGGTTCCCGGGCGCTTTAGCCGAGGCCGGCGATAGGTTTGGGAGCTTACGGGTCTCCTGGCC	ATTGGCCGTCATGGGCCAGAACTTAATTCTGAACATGAATGACCACGGCTTTGTGGTAAGCGGCGTGGGCGCATTGTCTTCTCTCTGGTTCCCGGGCGCTTTAGCCGAGGCCGGCGATAGGTTTGGGAGCTTACGGGTCTCCTGGCC
TACAGGCATGAGCCACTGAACCTGGGCCTGGTGTGTTTTTCTTACCTTGGTTTAAAGATCAAATGGAATATTATCATACCTACTGAATATTGAGAGTTTAAAACAGGGTAAAATACGTATTTAAGAAAAATTAACGTATGTGTAAGT	TACAGGCATGAGCCACTGAACCTGGGCCTGGTGTGTTTTTCTTACCTTGGTTTAAAGATCAAATGGAATATTTTCATACCTACTGAATATTGAGAGTTTAAAACAGGGTAAAATACGTATTTAAGAAAAATTAACGTATGTGTAAGT
GCTCAGATATCTCCTCAGAGGTGGCAGCTTGTTTGCTTTTATCTAAAATAGCCACTTCTACCACTTTCACTGTGATCTTTTATCTCCTAACCCGGCTTTATTTTTCTTTCCAACATTATGCTATTTGTATTAGTTAATTGTCTCATG	GCTCAGATATCTCCTCAGAGGTGGCAGCTTGTTTGCTTTTATCTAAAATAGCCACTTCTACCACTTTCACTGCGATCTTTTATCTCCTAACCCGGCTTTATTTTTCTTTCCAACATTATGCTATTTGTATTAGTTAATTGTCTCATG
CATATCTAACCATAGAAAGGGTACAAATATGATAGTAACAATACGATATTATTAATATAATCTTTTTTTTAGACGGAGTCTTGCCCTGTCACCCAGGCTGGAGTGCAATGGTGCAATCTTGGCTCGCTGCAACCTCCGCCTCCTGGG	CATATCTAACCATAGAAAGGGTACAAATATGATAGTAACAATACGATATTATTAATATAATCTTTTTTTTAGGCGGAGTCTTGCCCTGTCACCCAGGCTGGAGTGCAATGGTGCAATCTTGGCTCGCTGCAACCTCCGCCTCCTGGG
GCATGGACTCAGCCTAATTTGAGGGAAACTGTTAGTAATAGGCCTATACACTATGCTAGTCAGTCACTAAGCAGAAAGTCCCCACAGAGTCTGGGTGGTTATCATCACCACCATTTAGCGTAGCTTACCTGGTGTCAGGCACTGTGT	GCATGGACTCAGCCTAATTTGAGGGAAACTGTTAGTAATAGGCCTATACACTATGCTAGTCAGTCACTAAGCTGAAAGTCCCCACAGAGTCTGGGTGGTTATCATCACCACCATTTAGCGTAGCTTACCTGGTGTCAGGCACTGTGT
ACCCCTCCTGCCCTCCCTGTACATTTAAGAGAAGCCCGAGTAGCCGCACGTGACGGGATTTTTCTTTAAGGCTTGTCAAAGGCACTGTTCGAGGGGGATCTTTTCACCTGGCTCTGAGGCTGAGGGATGGACACTGCTGGAATGGAG	ACCCCTCCTGCCCTCCCTGTACATTTAAGAGAAGCCCGAGTAGCCGCACGTGACGGGATTTTTCTTTAAGGCGTGTCAAAGGCACTGTTCGAGGGGGATCTTTTCACCTGGCTCTGAGGCTGAGGGATGGACACTGCTGGAATGGAG
CCTTGCTGTGTCTCCCAGGCTGGGGTGCAGAGGCACAATCTCCTGGGTTCAAGCAATTCTCCTGCCTCGGCCACCTGAGCAGCTGGGATTATAGGCACCCACCACCAAGCCCAGCTAATTTTGTATTTTTAGTAGAGACGGTGTTTC	CCTTGCTGTGTCTCCCAGGCTGGGGTGCAGAGGCACAATCTCCTGGGTTCAAGCAATTCTCCTGCCTCGGCCTCCTGAGCAGCTGGGATTATAGGCACCCACCACCAAGCCCAGCTAATTTTGTATTTTTAGTAGAGACGGTGTTTC
TGCACTCCAGCCTGAGTGGCAGAGCAAGACTCCATCCCAAAACAACAACAACAACAACAACAACAACAACAAAAACCCATATAGTATATTTGGGAAAATTTTCAGAATTGTAGCTTATTACAGCTTATTAGTGGCAGTGTTAGGACT	TGCACTCCAGCCTGAGTGGCAGAGCAAGACTCCATCCCAAAACAACAACAACAACAACAACAACAACAACAACAACCCATATAGTATATTTGGGAAAATTTTCAGAATTGTAGCTTATTACAGCTTATTAGTGGCAGTGTTAGGACT
GCTTGTCAGGATAGAAGAGAAATTAAACAGATGTGACTGTGGTAGGAAAAACCTGCAAAAGGTGCCTTGGGCCGGATGCAGTGGCTCACATCTGTAATCCCAGTGCTTTGGGAGGCTGAGGCGGGAGGATTGCTTCACATCAAGAGT	GCTTGTCAGGATAGAAGAGAAATTAAACAGATGTGACTGTGGTAGGAAAAACCTGCAAAAGGTGCCTTGGGCTGGATGCAGTGGCTCACATCTGTAATCCCAGTGCTTTGGGAGGCTGAGGCGGGAGGATTGCTTCACATCAAGAGT
CGAGAATCGCTTGAACCTGGGAGGTGGAAGTTGCAGTGAGCCGAGATTGCGCCACTGCACTCCAGCTTGGGCGACAGAGCCAGACACAGTCTCAAAGAAAAAAAAAAAATTCGGTCCTCAGCAAACTAGAGACTTGCTGTGCTTATT	CGAGAATCGCTTGAACCTGGGAGGTGGAAGTTGCAGTGAGCCGAGATTGCGCCACTGCACTCCAGCTTGGGCAACAGAGCCAGACACAGTCTCAAAGAAAAAAAAAAAATTCGGTCCTCAGCAAACTAGAGACTTGCTGTGCTTATT
GCCTTCCAAAATGTTGGGATTACGGGCGTGACCCATTGTGCCCAGCCTTTTCTACTGTTCTTGAACACACCAGGCATAGTCCTACCATAGGGCACTTGCTCTTACTCTTTCTTTTTCTTTTTTTTTTTTTTTTGAGACAGCCTTGCT	GCCTTCCAAAATGTTGGGATTACGGGCGTGACCCATTGTGCCCAGCCTTTTCTACTGTTCTTGAACACACCAAGCATAGTCCTACCATAGGGCACTTGCTCTTACTCTTTCTTTTTCTTTTTTTTTTTTTTTTGAGACAGCCTTGCT
GTGAGCCGAGATGGCGCCACTGCACTCCAGCCTGGAGACAGAGCGAGACTCCATCTCAAAAAAAAAAAAAAATAAATTCTGAAGTCATAATAAGTAATAAAATTATAGGAATATGTAGCAATATTAAAAAATTACCAACATAGCCAG	GTGAGCCGAGATGGCGCCACTGCACTCCAGCCTGGAGACAGAGCGAGACTCCATCTCAAAAAAAAAAAAAAAGAAATTCTGAAGTCATAATAAGTAATAAAATTATAGGAATATGTAGCAATATTAAAAAATTACCAACATAGCCAG
AACTTGGAGTGGAGCATAGATTCCTAGTTGACACTGTGGTTTCTTGCCACATTTGCAGGACCTCTCTACCTGTCTCTTCTACTTCCTTCCCTGTTTACTCTGCTCCACCCATATTGCCTTTTTTCCTGTTTCAAGAACATACCAGAA	AACTTGGAGTGGAGCATAGATTCCTAGTTGACACTGTGGTTTCTTGCCACATTTGCAGGACCTCTCTACCTGCCTCTTCTACTTCCTTCCCTGTTTACTCTGCTCCACCCATATTGCCTTTTTTCCTGTTTCAAGAACATACCAGAA
AGCATCATTCTGTTGCCCAGGCTGGAGTGCAATGGCATGATCTTGGCTCACTGCAACCTCTGTCCCCCACCCTTACCACTGGGTTCAAGCAATTCTTAGGCCTCAGCCTCCTAAGTAGCTGGGACTACAGGATGCACCACCACGCCC	AGCATCATTCTGTTGCCCAGGCTGGAGTGCAATGGCATGATCTTGGCTCACTGCAACCTCTGTCCCCCACCCCTACCACTGGGTTCAAGCAATTCTTAGGCCTCAGCCTCCTAAGTAGCTGGGACTACAGGATGCACCACCACGCCC
AAAAAAAAAATTAGGTGGGCTTGGTGGCGGGTGCCTGTAATCCCAGCTACTTGGGAGGCTGAGGCAGGTGAACTGCTTGAACCCAGGGAGGTGGAGGTTGCAGTGAGCCGAGATCGCACCACTGCACTCCAGCCTGGGTGATGGAAC	AAAAAAAAAATTAGGTGGGCTTGGTGGCGGGTGCCTGTAATCCCAGCTACTTGGGAGGCTGAGGCAGGTGAATTGCTTGAACCCAGGGAGGTGGAGGTTGCAGTGAGCCGAGATCGCACCACTGCACTCCAGCCTGGGTGATGGAAC
GAAATTATGAGGAAAAAGCTGCGGGGAAGGGGCAGATGATTATCAGTTTACATGTCTTTGGGCATTTTAGGTAGAGTGAAATCTAGGCCTTGCAAATCATATCTCTTTAGAATCATTCAAAATTTGCTTAGGAAGAGCAGAATTGTT	GAAATTATGAGGAAAAAGCTGCGGGGAAGGGGCAGATGATTATCAGTTTACATGTCTTTGGGCATTTTAGGTTGAGTGAAATCTAGGCCTTGCAAATCATATCTCTTTAGAATCATTCAAAATTTGCTTAGGAAGAGCAGAATTGTT
GCTCATAGTTCTTGAGGCCAGATGTCCAAAATCAGTATCACAGGTTAAAATCGAGGTGCTGGCAGGGCTATGCCCCTGGAGGCTCTAGGGGAGAATCTGTTTCTCACCCCTCCAGTTTGTGGTGGTTGCCAGAGTTACTTGACTTGT	GCTCATAGTTCTTGAGGCCAGATGTCCAAAATCAGTATCACAGGTTAAAATCGAGGTGCTGGCAGGGCTATGACCCTGGAGGCTCTAGGGGAGAATCTGTTTCTCACCCCTCCAGTTTGTGGTGGTTGCCAGAGTTACTTGACTTGT
TGTGCAGTGGCACAATCACGGTTCACTGCAGCCTTGACCTCTAGAGCTCAAGTGATCTTCCCACTTCAGCCCCCTGAGTAGCTGGGACCACAGACACACGCCATCATGCCTAGCTAATTTTTTTTTTTTTTTGAGACAGTCTTGCTC	TGTGCAGTGGCACAATCACGGTTCACTGCAGCCTTGACCTCTAGAGCTCAAGTGATCTTCCCACTTCAGCCCTCTGAGTAGCTGGGACCACAGACACACGCCATCATGCCTAGCTAATTTTTTTTTTTTTTTGAGACAGTCTTGCTC
GTGGCATTAAATTGTAGGCCATAATTCCCCATGTGCCGTCCCCACACGTCACCCTGCCGTTCAAGAAACCTTCCTGTGTCTCTCCTCCAGCACTGCTCTTTTCCAAGAGTCTTTTACATTTATTTTGTTTTATTTTATTTATTTTTG	GTGGCATTAAATTGTAGGCCATAATTCCCCATGTGCCGTCCCCACACGTCACCCTGCCGTTCAAGAAACCTTTCTGTGTCTCTCCTCCAGCACTGCTCTTTTCCAAGAGTCTTTTACATTTATTTTGTTTTATTTTATTTATTTTTG
TTTACTCATGGTGGGAGGTAAAGGGGGAGCAGACACTTCACAGAGAAACAGCAGGAGCAAGGTGCGGAGAGGCGCCACTTACTCTTAAAACAACCAGATCTGGTAAGAACTCACTCACTATCACAAGTAGAGATGGCACCAAGCCAC	TTTACTCATGGTGGGAGGTAAAGGGGGAGCAGACACTTCACAGAGAAACAGCAGGAGCAAGGTGCGGAGAGGTGCCACTTACTCTTAAAACAACCAGATCTGGTAAGAACTCACTCACTATCACAAGTAGAGATGGCACCAAGCCAC
CTGTTCAAAAAGGTGGAAAATGGTACCCCACAGGAGTCACTGGTCCATAGTATTAATAATTCTGAGATCCAACCAGGCATATGTCACCAGTTCCTTGTTCAGGGCTCAGTCCTACAGCCCAGGAATTGTTCACCAAGCCTCTCAGCT	CTGTTCAAAAAGGTGGAAAATGGTACCCCACAGGAGTCACTGGTCCATAGTATTAATAATTCTGAGATCCAAACAGGCATATGTCACCAGTTCCTTGTTCAGGGCTCAGTCCTACAGCCCAGGAATTGTTCACCAAGCCTCTCAGCT
TCATATCTCACTGCATCCTTCACCTCCAGGCTCAGCCATCCTCCCACCTCAGCCACCTGAATAGCTGGAACTACAGATGCACACCACCATCCCAGCTAATTTTTAAGTTTATAAATTTTATAGAGTTGGGGTCTCATTATGCTGCCC	TCATATCTCACTGCATCCTTCACCTCCAGGCTCAGCCATCCTCCCACCTCAGCCACCTGAATAGCTGGAACTGCAGATGCACACCACCATCCCAGCTAATTTTTAAGTTTATAAATTTTATAGAGTTGGGGTCTCATTATGCTGCCC
AGAAGTTGTTCTGTGTTTTCTTTCTCTCTTTGGCTTTTGGCTTCAGGAATATCAGGATAAATAGGAAAGGAAGAATTTTTCTTTTCTTTTTTCTTTTCTTGTTTTTTTTTTTTTTTTTTTTTTTTGAGATGGAGTTTTTGCTCTTGT	AGAAGTTGTTCTGTGTTTTCTTTCTCTCTTTGGCTTTTGGCTTCAGGAATATCAGGATAAATAGGAAAGGAAAAATTTTTCTTTTCTTTTTTCTTTTCTTGTTTTTTTTTTTTTTTTTTTTTTTTGAGATGGAGTTTTTGCTCTTGT
TCCCCATGTCTCTTGCAAAGCTGATAGTTTGGGAAGTCAGGTGACCCATGGAAGCATGCATGAGTCTGGTGCGCTGCTTTTCTTTTGTTGTTGTTGTTTTGAGACGGAGTCTTGCTCCGTCGCCCAGGCTGGAGTGCAGTGGCACAA	TCCCCATGTCTCTTGCAAAGCTGATAGTTTGGGAAGTCAGGTGACCCATGGAAGCATGCATGAGTCTGGTGCTCTGCTTTTCTTTTGTTGTTGTTGTTTTGAGACGGAGTCTTGCTCCGTCGCCCAGGCTGGAGTGCAGTGGCACAA
ACAACAGTCAACATGGCCTTTTTCCCCAAGTTCTTCCTGCATACATTTAACTCAGCATAGACTTTAATAGTAGTATTAATATTAGAAACATAAAGGAACATTTTATGATGATAATGGCTATATCAATACATTATGAAGATTTAGCCA	ACAACAGTCAACATGGCCTTTTTCCCCAAGTTCTTCCTGCATACATTTAACTCAGCATAGACTTTAATAGTAATATTAATATTAGAAACATAAAGGAACATTTTATGATGATAATGGCTATATCAATACATTATGAAGATTTAGCCA
TTTGGAGCACTTGGCAAAAGCATGCTAGTGTTCTCAGACGGGTGAACTAATTTGGAAGACAACAAGTTCATATTACCAGTCTGTCTGTCCCCCCAGTTGAAAATAGTTTCTTTTTCTCCATTTTTTCTTGATGGAAGGGGTGTCCTT	TTTGGAGCACTTGGCAAAAGCATGCTAGTGTTCTCAGACGGGTGAACTAATTTGGAAGACAACAAGTTCATACTACCAGTCTGTCTGTCCCCCCAGTTGAAAATAGTTTCTTTTTCTCCATTTTTTCTTGATGGAAGGGGTGTCCTT
AAAAAAAAAAAAAAAAACAGATCTCACAATGATACAGTCAGTTCTCAAGTGGCATCTGTTGAAGCAGTGGATGTCGTCACCCAGTATTAGAATATGTCTTAAACCAAATTAAAACTTTACTTTACACAGAGTTTTATGGACACATGA	AAAAAAAAAAAAAAAAACAGATCTCACAATGATACAGTCAGTTCTCAAGTGGCATCTGTTGAAGCAGTGGATATCGTCACCCAGTATTAGAATATGTCTTAAACCAAATTAAAACTTTACTTTACACAGAGTTTTATGGACACATGA
ATAGCATTTGATTAATGTGAGTTTGAGTCATTTTACAGAATATACATGGAAAACAAGTCAGGGCCCACAGGCAAGACTTAGATAAGTAAAGAAGACTTTGAGTATGAATCCAAGTAGCACCTAATTATTATACTATCCAGATAGTTT	ATAGCATTTGATTAATGTGAGTTTGAGTCATTTTACAGAATATACATGGAAAACAAGTCAGGGCCCACAGGCGAGACTTAGATAAGTAAAGAAGACTTTGAGTATGAATCCAAGTAGCACCTAATTATTATACTATCCAGATAGTTT
TGCACCATTGCATTCCAGCCTGGGTGACAGAGCGAGACTCTGTCTCAAAAAAAAAAAAAAAAGGAAAGAAAATAAATGTCAAATTGTTTTCCAAAGTGATTGTACCATTTTACATTCCCACCAGAAATATGTGATTGTTCCAGTTGC	TGCACCATTGCATTCCAGCCTGGGTGACAGAGCGAGACTCTGTCTCAAAAAAAAAAAAAAAAGGAAAGAAAAGAAATGTCAAATTGTTTTCCAAAGTGATTGTACCATTTTACATTCCCACCAGAAATATGTGATTGTTCCAGTTGC
TCTTGGCTCTTAGTACCCCATACTCTCCTAATTGCCTTCCTTCCTCCCAGGTTGGTTATTCTTTACCTCCTTCGGTTAAAGTCCACCAGGCTTTTGTCCTCAGATCTCTCTCTCCAGAAAAGAGAGACGCCCTAGATGATTTCTTCT	TCTTGGCTCTTAGTACCCCATACTCTCCTAATTGCCTTCCTTCCTCCCAGGTTGGTTATTCTTTACCTCCTTAGGTTAAAGTCCACCAGGCTTTTGTCCTCAGATCTCTCTCTCCAGAAAAGAGAGACGCCCTAGATGATTTCTTCT
ACGGCCGGGCGCGGTGGCTCATGCCTGTAATCCCAGCACTTTGGGAGGCCGAGGCTGGTGCATCACTGAGGTTGGGAGTTTGAGACCAGCCTAACCAACATGGAGAAACCCCATCTCTACTAAAAATACAAATTTAGCCGGGCATGG	ACGGCCGGGCGCGGTGGCTCATGCCTGTAATCCCAGCACTTTGGGAGGCCGAGGCTGGTGCATCACTGAGGTCGGGAGTTTGAGACCAGCCTAACCAACATGGAGAAACCCCATCTCTACTAAAAATACAAATTTAGCCGGGCATGG
GTCTTGATCTCCTGACCTTGTGATCCGCCCACCTCGGCCTCCCAAAGTGCTGGGATTACAGGCGTGAGCCACCGTATTTTAAAATTTTGTTTAGAGATGTGGTCTTGCTATGATGCCCAGGCTGATGTCAAACACCTGGACTCAAGC	GTCTTGATCTCCTGACCTTGTGATCCGCCCACCTCGGCCTCCCAAAGTGCTGGGATTACAGGCGTGAGCCACTGTATTTTAAAATTTTGTTTAGAGATGTGGTCTTGCTATGATGCCCAGGCTGATGTCAAACACCTGGACTCAAGC
GTTCAGCATGAGTCTGTAGATCTGTTCTTTTCTATATCCTAGATGTGGACAGGACCTGGAGAGATGGCATGCCTGCTTTCTTCTTTGTGGCCTTTGCTTTCATTCAAGTTCAATTTGTTCATAAATACATTCTCATAACTTCTCAGG	GTTCAGCATGAGTCTGTAGATCTGTTCTTTTCTATATCCTAGATGTGGACAGGACCTGGAGAGATGGCATGCGTGCTTTCTTCTTTGTGGCCTTTGCTTTCATTCAAGTTCAATTTGTTCATAAATACATTCTCATAACTTCTCAGG
AGGGGGCTTGTTGGATGCTGGCCAGGTGTGAGGAAGGCTGGTGTGGTCTCGGCATTCAGCCGACTGGGATTACTCGGGCAGCCATATTGGGAGGATGATCTGACAAATCCTTTAGGAGCCAAGTCCAGTTGTTGGAAGGCACCGAGT	AGGGGGCTTGTTGGATGCTGGCCAGGTGTGAGGAAGGCTGGTGTGGTCTCGGCATTCAGCCGACTGGGATTAGTCGGGCAGCCATATTGGGAGGATGATCTGACAAATCCTTTAGGAGCCAAGTCCAGTTGTTGGAAGGCACCGAGT
GTTCCTGCAGCCCCCCGCAGCAGCCCCACTCCCCGGCTCACCCTACGATTGGCTGGCCGCCCCGAGCTCTGTGCTGTGATTGGTCACAGCCCGTGTCCGTCGCGGGCGCCGGGGCGGATACGAGGTGACGCGCAGAGGCCCAGCTCG	GTTCCTGCAGCCCCCCGCAGCAGCCCCACTCCCCGGCTCACCCTACGATTGGCTGGCCGCCCCGAGCTCTGTACTGTGATTGGTCACAGCCCGTGTCCGTCGCGGGCGCCGGGGCGGATACGAGGTGACGCGCAGAGGCCCAGCTCG
AGGTTTTCGTAACTCTCCATGGCGCTCACCACAGTATTTACGCAAGGAGGTCCACGCTATGATGAAGTGGTGTCTACTGTTGAATTGATGAGTTCCTCTTTATTAACCTACTATAGTTTCATTTTACTCTTAGCCGTCAGGAAGCTA	AGGTTTTCGTAACTCTCCATGGCGCTCACCACAGTATTTACGCAAGGAGGTCCACGCTATGATGAAGTGGTGACTACTGTTGAATTGATGAGTTCCTCTTTATTAACCTACTATAGTTTCATTTTACTCTTAGCCGTCAGGAAGCTA
CCTCCCGAGTAGCTGGGACTACAGGTGCCCGCCACCACACCCAGCTAATTTTTTATTTTATTTTATTTATTTATTTACTTTTGAGATGGAGTTTTGCTCTCGTTGCCCACGCCAGAGTGTAGTGGTGCAATCTTGGCTCACTGCAAC	CCTCCCGAGTAGCTGGGACTACAGGTGCCCGCCACCACACCCAGCTAATTTTTTATTTTATTTTATTTATTTGTTTACTTTTGAGATGGAGTTTTGCTCTCGTTGCCCACGCCAGAGTGTAGTGGTGCAATCTTGGCTCACTGCAAC
TCACTATCTAACATGCTATATCTATTATGTACTTTACAGTCCACTTCCCCCCACTAGAATGTAAGCCCGGGGTGGGGGGGGGCAGAGATTTTTTTCTGTATCCTTGGCACCTATAAGTGTGCCTGGCAAATATATGTGTTGAATGAA	TCACTATCTAACATGCTATATCTATTATGTACTTTACAGTCCACTTCCCCCCACTAGAATGTAAGCCCGGGGGGGGGGGGGGCAGAGATTTTTTTCTGTATCCTTGGCACCTATAAGTGTGCCTGGCAAATATATGTGTTGAATGAA
AAAGAGGCTGGGTAAAAAGGAGTTGCTGAAGTCATAGTATGTTGTGGAAATGAAGTAAATCTTTTCCACTCTGCTCTGATAGCAAAGTAGTTTTTCAAAGAGATGAATTGGCCAAACACATCTTACCCTAGCAAAGCACATGCTGCT	AAAGAGGCTGGGTAAAAAGGAGTTGCTGAAGTCATAGTATGTTGTGGAAATGAAGTAAATCTTTTCCACTCTACTCTGATAGCAAAGTAGTTTTTCAAAGAGATGAATTGGCCAAACACATCTTACCCTAGCAAAGCACATGCTGCT
AACTGAGGCATTGTCTCTGGCTCTCAGTTTGTGCATCCATCTTTCAGTGATGCAGAACTCTCTATGCACATGATCCTAATACTGGTGTCTTTGTTCATCTCCAGCCTTCATGCTGAGGTAATTTAAATTACAAGTTCAACAGTAGAG	AACTGAGGCATTGTCTCTGGCTCTCAGTTTGTGCATCCATCTTTCAGTGATGCAGAACTCTCTATGCACATGTTCCTAATACTGGTGTCTTTGTTCATCTCCAGCCTTCATGCTGAGGTAATTTAAATTACAAGTTCAACAGTAGAG
GTGTCTTTGTTCATCTCCAGCCTTCATGCTGAGGTAATTTAAATTACAAGTTCAACAGTAGAGCATGCATTGAATTAACCAAAAAGTATGTCCAGGTTTAAAAGTATTAAATTTAAATTTAATGGTACATTAGAATCACATATTGTT	GTGTCTTTGTTCATCTCCAGCCTTCATGCTGAGGTAATTTAAATTACAAGTTCAACAGTAGAGCATGCATTGGATTAACCAAAAAGTATGTCCAGGTTTAAAAGTATTAAATTTAAATTTAATGGTACATTAGAATCACATATTGTT
TATCCATTATGAGGTGGCTCTGAAAAATCAACCTAGTATAAGTTGGATGGCTTTGCTTTTCTGCTTCTGTTATAACCCATTTTTCTAGAAAAGCTTCCACTTCTACTTAAAGATAAGAGGCAAATCATTTTCCTGTTCCCTTATGCA	TATCCATTATGAGGTGGCTCTGAAAAATCAACCTAGTATAAGTTGGATGGCTTTGCTTTTCTGCTTCTGTTACAACCCATTTTTCTAGAAAAGCTTCCACTTCTACTTAAAGATAAGAGGCAAATCATTTTCCTGTTCCCTTATGCA
TTTCAGCAGTGCTTTATGATGCATGGAATGTTTGATGTGGGACTTGGAGAGCTCTGTTTGGAAACAGTGGATAGTCATACTTATACCCTTTGTCTCATGACAGCCTGTAATTGGGTCACTGCTAGGGAACCAAAAGAAGCAGGGCTG	TTTCAGCAGTGCTTTATGATGCATGGAATGTTTGATGTGGGACTTGGAGAGCTCTGTTTGGAAACAGTGGATGGTCATACTTATACCCTTTGTCTCATGACAGCCTGTAATTGGGTCACTGCTAGGGAACCAAAAGAAGCAGGGCTG
AACTATAATGAACTTTTGTATACCCATACTTATATATTTTTCCTGAATTATGTGAAAATTATAGATATCATGGCAGTTTACCCCAAATACTTCCATGCTTATCTCTTAAAATCAAGAATATTCTTTTTTTTTTTTTTTTTTTTTTTT	AACTATAATGAACTTTTGTATACCCATACTTATATATTTTTCCTGAATTATGTGAAAATTATAGATATCATGACAGTTTACCCCAAATACTTCCATGCTTATCTCTTAAAATCAAGAATATTCTTTTTTTTTTTTTTTTTTTTTTTT
GAGTGGTTCTCAAACTTTAATGTCAGTTAGAATTTTGGGGTCTTATGAGAACACAGACTATTGGGCCCACCTTCAGAGTTTCTGATTCACTAGGTCTGGGGCGAGACCTGATAAATTTGCATACCTCATAAATTCCCAGGTGATTCT	GAGTGGTTCTCAAACTTTAATGTCAGTTAGAATTTTGGGGTCTTATGAGAACACAGACTATTGGGCCCACCTCCAGAGTTTCTGATTCACTAGGTCTGGGGCGAGACCTGATAAATTTGCATACCTCATAAATTCCCAGGTGATTCT
TTTAGCTCTGGTATTCAGGATATTCACTACTACATGAAACTGTCTCTCATTCTCTTGCTAACCATGTCTGCTCTCTAAAGTAAGAGAGGAAAGGAGAACTTCAAAGATGGAACAAGCAAACACAAAATATGCCATCTTCTTTTTCAT	TTTAGCTCTGGTATTCAGGATATTCACTACTACATGAAACTGTCTCTCATTCTCTTGCTAACCATGTCTGCTATCTAAAGTAAGAGAGGAAAGGAGAACTTCAAAGATGGAACAAGCAAACACAAAATATGCCATCTTCTTTTTCAT
ATTATCTCTATTATCTGGTATTATGCCAGAGTTGAAAATGGAAAAGTCTGCTTCCTTAAAGGGAATTAAAACATGCTATTGATACCAACATCCAACTCTTTGTAGTCTTTTTCTTTCTCTTGAAAAAACAGGGTTTATTGATTTCTA	ATTATCTCTATTATCTGGTATTATGCCAGAGTTGAAAATGGAAAAGTCTGCTTCCTTAAAGGGAATTAAAACGTGCTATTGATACCAACATCCAACTCTTTGTAGTCTTTTTCTTTCTCTTGAAAAAACAGGGTTTATTGATTTCTA
CTTTTCAAATAGAAGTCATGTTTGAATTCCTATTCTTCTATATATCCACATGTATTCCTGCTCCTCTTGTATGTATCTAGTAGGAACTAGAATTCCTAGTTCCTGATTTAAAATAAGAAGTAAAGGCTGGGCGCGGTGGCTCATGCC	CTTTTCAAATAGAAGTCATGTTTGAATTCCTATTCTTCTATATATCCACATGTATTCCTGCTCCTCTTGTATATATCTAGTAGGAACTAGAATTCCTAGTTCCTGATTTAAAATAAGAAGTAAAGGCTGGGCGCGGTGGCTCATGCC
GCCAGTTGGGTGTAAGTTTGGCATCAATATGGTGATGTCCCTGAAGCAGGAAACCACAAACTTGCATCAGGACGGGTGAACCCAGCCCAGGTTGGAAATGGAGCAGGCCAAAACTCCCAGGCTGATCAGTAATGGGATCTTGCCTAT	GCCAGTTGGGTGTAAGTTTGGCATCAATATGGTGATGTCCCTGAAGCAGGAAACCACAAACTTGCATCAGGAGGGGTGAACCCAGCCCAGGTTGGAAATGGAGCAGGCCAAAACTCCCAGGCTGATCAGTAATGGGATCTTGCCTAT
TGCATTTTGTGTAAACCCAGTTGTCCTTTTTTATTCCTCTTTAGACATAAATGTGCTAACTATTCCTTTCTATACACAATTTATTTTCTAAGATTAAAAATAATAATTGCTAGGTTTGGTGGCACATGCGTACAGCCCCAGCTACTT	TGCATTTTGTGTAAACCCAGTTGTCCTTTTTTATTCCTCTTTAGACATAAATGTGCTAACTATTCCTTTCTAGACACAATTTATTTTCTAAGATTAAAAATAATAATTGCTAGGTTTGGTGGCACATGCGTACAGCCCCAGCTACTT
GTTACCTTCCTTTTTACATAATCATAGTTATGAAGTAGTTACGTAGCTTTTAGCTAATTAGAGTAGTAAGGGTTTTTTTGTTTTTTTCTTAAACTAAGTTGCAACGTCTTGTTGGATACTAGAAAATGACTATCAAATGGTTATTTT	GTTACCTTCCTTTTTACATAATCATAGTTATGAAGTAGTTACGTAGCTTTTAGCTAATTAGAGTAGTAAGGGGTTTTTTGTTTTTTTCTTAAACTAAGTTGCAACGTCTTGTTGGATACTAGAAAATGACTATCAAATGGTTATTTT
AAAAAAACGATATTAGAACAATAACAACAAAATAGTTTGTGGGTATCTATTAAATTAAGTTTCCATTTGTTACATAAATGTAAGATTAATTTTTCAAATGGCTTTTTTTTTTAAGCTAACAAATGGTATTTGTCTGGCTCTAGTGTT	AAAAAAACGATATTAGAACAATAACAACAAAATAGTTTGTGGGTATCTATTAAATTAAGTTTCCATTTGTTATATAAATGTAAGATTAATTTTTCAAATGGCTTTTTTTTTTAAGCTAACAAATGGTATTTGTCTGGCTCTAGTGTT
AATTAACTGGGCGTGGTGGCACGTGCCTGTAGTCCCAGCTGCTCGGGAGGCTGAGGCAGGAGAATCACTTGATCCCCAGAGGTGAGGTTGCAGTGATCTGAGATCGCGCCACTGCAGCCTGGTGACAAAGGAAGACTCCGTCTCAAA	AATTAACTGGGCGTGGTGGCACGTGCCTGTAGTCCCAGCTGCTCGGGAGGCTGAGGCAGGAGAATCACTTGAACCCCAGAGGTGAGGTTGCAGTGATCTGAGATCGCGCCACTGCAGCCTGGTGACAAAGGAAGACTCCGTCTCAAA
TATAAGTGTAAACACTCAGCAAGTGATTGGTAAATTGTCACTTCAGTGTGTGTCTTCAGATGCGATTTAATAGTAAACCTTTCTATGTTGACTGCTGGGTTGTGTTCAGGAGGTTAGTGTGTTATGGCGAAATTGTAGTGAAACAAA	TATAAGTGTAAACACTCAGCAAGTGATTGGTAAATTGTCACTTCAGTGTGTGTCTTCAGATGCGATTTAATACTAAACCTTTCTATGTTGACTGCTGGGTTGTGTTCAGGAGGTTAGTGTGTTATGGCGAAATTGTAGTGAAACAAA
TATTGTGGTTAGTACTATAATAAGTACTAGTCAAGATGCCTTGTTTAGGTCGGGTGCATCCTGTTGTCCTGTCTGTTGAAGGTTTTCACTTTGAGAAGATTGTATAGATTTCTACCCAGCTATCTTTAATAGACCTTAAAATTATGT	TATTGTGGTTAGTACTATAATAAGTACTAGTCAAGATGCCTTGTTTAGGTCGGGTGCATCCTGTTGTCCTGTTTGTTGAAGGTTTTCACTTTGAGAAGATTGTATAGATTTCTACCCAGCTATCTTTAATAGACCTTAAAATTATGT
TTAATGCAGTGTGGTAGTTCACTGAAGCATAAGCACCTTAGTTCTGCTCTTATTTTGTGAATGGTGAGAATTTCTTTCGGGCAGACCTGCATTTTAATGCTGCACGCAGATAACATCTTTCATCCGTAGCGCCAGGGCAATGGTTGT	TTAATGCAGTGTGGTAGTTCACTGAAGCATAAGCACCTTAGTTCTGCTCTTATTTTGTGAATGGTGAGAATTCCTTTCGGGCAGACCTGCATTTTAATGCTGCACGCAGATAACATCTTTCATCCGTAGCGCCAGGGCAATGGTTGT
TCCTTAATATAAAATGTTCTTTTTCTTTGGGGATCTTAAGTCTTAACTATTTGCTTATTAAAGCCTTAGCTCTTACACTTGAGATTACCCTTTCCTTTGACCTTCCTCTTGATGTAAAGGAGAAATTTCTCCCTAACTGCCAAGTGG	TCCTTAATATAAAATGTTCTTTTTCTTTGGGGATCTTAAGTCTTAACTATTTGCTTATTAAAGCCTTAGCTCATACACTTGAGATTACCCTTTCCTTTGACCTTCCTCTTGATGTAAAGGAGAAATTTCTCCCTAACTGCCAAGTGG
CAGGTGATCCACCCGCCTCAGCCTCCCAAAGTGCTAGGATTACAGGTGTGTGGACGCCCAGCCAGATAAAAGTTTTTTAAAGAAGGCAGAGGTGGCTGGGTGCGGTGGCACACGCCTGTAATCCCAGCACTTTGGGAGGCTGAGGTG	CAGGTGATCCACCCGCCTCAGCCTCCCAAAGTGCTAGGATTACAGGTGTGTGGACGCCCAGCCAGATAAAAGGTTTTTAAAGAAGGCAGAGGTGGCTGGGTGCGGTGGCACACGCCTGTAATCCCAGCACTTTGGGAGGCTGAGGTG
AAATTTATTTGGAAACGTGGTTTCATTGAAAGATGGAATTCTGTGTAGAGCCATGCTTCTGTTAATAAAGATGAAGTTTGGGCCGGGTGCAGTGGCTCACGCCTGTAATCCCAGCACTTTGGGAGGCCGAGGCGGGGTGGATCACGA	AAATTTATTTGGAAACGTGGTTTCATTGAAAGATGGAATTCTGTGTAGAGCCATGCTTCTGTTAATAAAGATAAAGTTTGGGCCGGGTGCAGTGGCTCACGCCTGTAATCCCAGCACTTTGGGAGGCCGAGGCGGGGTGGATCACGA
GGTGAAGGTCCGTCCTGCCCTGCCTTGGTTTCTTATTGCCACGTGTGCCCTTCTCTTTTGATTTCTGCACTCTCTGTTACGTGGTGTGAAATTTCCCTATTCTCTCTGGTTTTGAACTTCCTTTGTGAAGTGCTATATGCCTTGGGA	GGTGAAGGTCCGTCCTGCCCTGCCTTGGTTTCTTATTGCCACGTGTGCCCTTCTCTTTTGATTTCTGCACTCCCTGTTACGTGGTGTGAAATTTCCCTATTCTCTCTGGTTTTGAACTTCCTTTGTGAAGTGCTATATGCCTTGGGA
TGTCGATAAGTTGAGGGAAGAAGGCTGCACACATCTGTAAGCTTTTGGAGCACAAATATCTCGAAGATACTTCAGGACTGTGAGTTAGGCATGTGGTCTCAGCATGTTATTATCAAGTGGAAAAGAGGACAGATGGAGGACTAAAGG	TGTCGATAAGTTGAGGGAAGAAGGCTGCACACATCTGTAAGCTTTTGGAGCACAAATATCTCGAAGATACTTTAGGACTGTGAGTTAGGCATGTGGTCTCAGCATGTTATTATCAAGTGGAAAAGAGGACAGATGGAGGACTAAAGG
CTTGGCCTCCCAAAGTGCTGGGATTACAGGCGTGAGCCACCGCGCCCGGCTTCTGTATGTGATTTCTTTTTCACTCTAATTCACTTTACTAATTTGTTCATAGGTGAGCTACATGGAAATTTACTGTGAAAGAGTACGAGATTTGCT	CTTGGCCTCCCAAAGTGCTGGGATTACAGGCGTGAGCCACCGCGCCCGGCTTCTGTATGTGATTTCTTTTTCTCTCTAATTCACTTTACTAATTTGTTCATAGGTGAGCTACATGGAAATTTACTGTGAAAGAGTACGAGATTTGCT
GAAGGCTGGTTCTAACCTATTCAGTGTAATTACCTGTGCGTATTGTTAATAGAATAAAAGGGCCTAGAGTTACGGCATTTCACTTTGTAAAGGTTGCTGATCTCTAATCTTAGAGCTTTTAATAAAAGTTAAAAAAATTTTTTTTCT	GAAGGCTGGTTCTAACCTATTCAGTGTAATTACCTGTGCGTATTGTTAATAGAATAAAAGGGCCTAGAGTTATGGCATTTCACTTTGTAAAGGTTGCTGATCTCTAATCTTAGAGCTTTTAATAAAAGTTAAAAAAATTTTTTTTCT
TTGCAGGACCTCTCTACCTGTCTCTTCTACTTCCTTCCCTGTTTACTCTGCTCCACCCATATTGCCTTTTTTCCTGTTTCAAGAACATACCAGAAACATTCCTGCTTCAAGGCCTCTACATTTACTTCTCCTCTTGCCTGAAATGTT	TTGCAGGACCTCTCTACCTGTCTCTTCTACTTCCTTCCCTGTTTACTCTGCTCCACCCATATTGCCTTTTTTGCTGTTTCAAGAACATACCAGAAACATTCCTGCTTCAAGGCCTCTACATTTACTTCTCCTCTTGCCTGAAATGTT
AGAAAATCAATGACAACTGTAATGAAGAAATGTCTTACTCTGTAGAGGTGAGTACAGCCGTGAGTTGACACCGTAAGCCCTTGTTTTCCATTCTCTCAAGCATCACTTAAATGGCTCCAAATTATGACTGTGGTACACATCACTTCA	AGAAAATCAATGACAACTGTAATGAAGAAATGTCTTACTCTGTAGAGGTGAGTACAGCCGTGAGTTGACACCATAAGCCCTTGTTTTCCATTCTCTCAAGCATCACTTAAATGGCTCCAAATTATGACTGTGGTACACATCACTTCA
ATTTGAGACAGGGTCTCACTCTGTTGCCCATGCTGGAGTGCAGTGGTGTGATCTTGGCTCACTGAGGCCTTGTCCTCCCAGGCTCAAGTGATCCTCCTGCCTTAGCCTCCAGAGTAGCTGGGACTAAAGCCATGTGCCACCACACCT	ATTTGAGACAGGGTCTCACTCTGTTGCCCATGCTGGAGTGCAGTGGTGTGATCTTGGCTCACTGAGGCCTTGACCTCCCAGGCTCAAGTGATCCTCCTGCCTTAGCCTCCAGAGTAGCTGGGACTAAAGCCATGTGCCACCACACCT
ATGACTTTAAACTTCAAACACTCTGAGATTCTCCCTCTTTTTTTTTTTTTTTAGAACAGTTAGTATTATTGGGTTTGATCCTTTATTGTTTGGGAATGAAGAAGCGTTCTGACATAGATATTTATTTATTTTTATTTTCATTATTCG	ATGACTTTAAACTTCAAACACTCTGAGATTCTCCCTCTTTTTTTTTTTTTTTAGAACAGTTAGTATTATTGGATTTGATCCTTTATTGTTTGGGAATGAAGAAGCGTTCTGACATAGATATTTATTTATTTTTATTTTCATTATTCG
CTCAGAGTAAGTGTTCTGTGAATGTTGGCTGTTTTTTAAATCTTGCATTTAATTCCTCTTTGGTTAGAAGTATACTTCTTTGCTTGGATTACCATTTGCATGTGGAGAGATGTTCCTTCTAGAACCATGTCTCCTTGTCACATGATT	CTCAGAGTAAGTGTTCTGTGAATGTTGGCTGTTTTTTAAATCTTGCATTTAATTCCTCTTTGGTTAGAAGTACACTTCTTTGCTTGGATTACCATTTGCATGTGGAGAGATGTTCCTTCTAGAACCATGTCTCCTTGTCACATGATT
CCTTGGTTTAAAGATCAAATGGAATATTATCATACCTACTGAATATTGAGAGTTTAAAACAGGGTAAAATACGTATTTAAGAAAAATTAACGTATGTGTAAGTGTTTCACTCCTTTAATTCTGTAAACTAGGTATTACCTCAATTTT	CCTTGGTTTAAAGATCAAATGGAATATTATCATACCTACTGAATATTGAGAGTTTAAAACAGGGTAAAATACCTATTTAAGAAAAATTAACGTATGTGTAAGTGTTTCACTCCTTTAATTCTGTAAACTAGGTATTACCTCAATTTT
ATGGAGGGCATTCATTTGAGTCCTTGGTATAGGGCAGTATAGAGGATCCATAAGACATGGTCCAAGCACTTTGAGGATATATGATGTTGGGGGAGCATCAGAGATTTGTTGACACATTTAAGTAAGGACTTGAATGTCGTACTTTGA	ATGGAGGGCATTCATTTGAGTCCTTGGTATAGGGCAGTATAGAGGATCCATAAGACATGGTCCAAGCACTTTCAGGATATATGATGTTGGGGGAGCATCAGAGATTTGTTGACACATTTAAGTAAGGACTTGAATGTCGTACTTTGA
CTTGTGGGTGAAAATATGGTTTATATGTTGAATGTGTTCCTTAATTACTGTAATTCTGTTTTTATGTGCATGGTTTCTGTGAAACAAATTAGAAGTCCAACACACTATTTTAGCTCAGTTGACCTTGATACAAGAACTGCTGTGTTA	CTTGTGGGTGAAAATATGGTTTATATGTTGAATGTGTTCCTTAATTACTGTAATTCTGTTTTTATGTGCATGCTTTCTGTGAAACAAATTAGAAGTCCAACACACTATTTTAGCTCAGTTGACCTTGATACAAGAACTGCTGTGTTA
GACATAATCTTTTGATGTATGAATGGACCCATCTCTCTTGCTGCCCCTGCAACACCAGATACTGGGACTCATCGATTTCTGATGATGAAAGATGTCGTTCTCATGGGAGTCTTTATGTTATACAAATGGAGAGCAAAGTTCCCAAAC	GACATAATCTTTTGATGTATGAATGGACCCATCTCTCTTGCTGCCCCTGCAACACCAGATACTGGGACTCATGGATTTCTGATGATGAAAGATGTCGTTCTCATGGGAGTCTTTATGTTATACAAATGGAGAGCAAAGTTCCCAAAC
CTTATCACTTTTAGAATAAAACTAAAAATCCTCACTTTGGCCACACAGCCTCACAGAATTTGGCCTCTGGCTAGCTATCTGATTTCACATTTGATCATTGTTTGCCCACCTGGCTATACTGCTGGTCTTGCTGTTCCTTAAATTTCA	CTTATCACTTTTAGAATAAAACTAAAAATCCTCACTTTGGCCACACAGCCTCACAGAATTTGGCCTCTGGCTGGCTATCTGATTTCACATTTGATCATTGTTTGCCCACCTGGCTATACTGCTGGTCTTGCTGTTCCTTAAATTTCA
GTCTCCTGACCTCGTGATCAGCCTGCCTCGGCCTCCCAAAGTGTTGGGATTACAGGCATAAGCCACCATGCCTAGCTGCTAATTTTTGTATTTTTGGCAGAGACAGGGTTTCCCCGTATTGGCCAGGCTGGTCTTGAACTCCTGACC	GTCTCCTGACCTCGTGATCAGCCTGCCTCGGCCTCCCAAAGTGTTGGGATTACAGGCATAAGCCACCATGCCCAGCTGCTAATTTTTGTATTTTTGGCAGAGACAGGGTTTCCCCGTATTGGCCAGGCTGGTCTTGAACTCCTGACC
AATGTGTTGACCGGACTAACATTTGTAACCACGAAGATCCATAGTTAAGGTTTTCATCCTACATTCATTAACGGGTATTCTGATTTTATACATCTTGCCAGCTTATAAATAAAGATCTGGTCTTTATTTATAAATATAAATATAAAT	AATGTGTTGACCGGACTAACATTTGTAACCACGAAGATCCATAGTTAAGGTTTTCATCCTACATTCATTAACTGGTATTCTGATTTTATACATCTTGCCAGCTTATAAATAAAGATCTGGTCTTTATTTATAAATATAAATATAAAT
AAGTAGCTATTTTATTTAAGCACTTTCTGGTCTTGGAGGAAATATTCTCCATGGCACAAATAAATGTTACTGTCTTGACATTTTGGAGTCCCAAGCACATGCAAATGGCTCTGTTCAATAATATCCCATTATATTCCAAGGTTCTCC	AAGTAGCTATTTTATTTAAGCACTTTCTGGTCTTGGAGGAAATATTCTCCATGGCACAAATAAATGTTACTGCCTTGACATTTTGGAGTCCCAAGCACATGCAAATGGCTCTGTTCAATAATATCCCATTATATTCCAAGGTTCTCC
TTGTATGAAAGATGATATTTTAGAAAGTATTATTGGCTTGTTTTTTTTTTTTTAAACACCATTGGGCTTAGAATGGAAGTGGGCATGCATTTTGAACATAGACTTGTTGGAAATGAATATGCTGTACACATGTGTTAGCTGCATTAA	TTGTATGAAAGATGATATTTTAGAAAGTATTATTGGCTTGTTTTTTTTTTTTTAAACACCATTGGGCTTAGATTGGAAGTGGGCATGCATTTTGAACATAGACTTGTTGGAAATGAATATGCTGTACACATGTGTTAGCTGCATTAA
TAATATAAAGAAATAAACATAAAACGAGAGGGGATTAACAATATCAAAATCTTGGCCGGGGGGGTGGTTTTCAGTGTGTTTGTTTGTTTTTTGAGACGGTGTTGTGCTCTGTCACCCAGGCTGGAGTTCAGTGGCATGATCTCGGGT	TAATATAAAGAAATAAACATAAAACGAGAGGGGATTAACAATATCAAAATCTTGGCCGGGGGGGTGGTTTTCTGTGTGTTTGTTTGTTTTTTGAGACGGTGTTGTGCTCTGTCACCCAGGCTGGAGTTCAGTGGCATGATCTCGGGT
ATGTCACTGCACTCCAGACTTGGCAATAGAGCAAGACCCTGCTTCAAAAAAAGGGTCTGTTTTTGAGACCCCGTATATATATTTAAAAAAATTTAAAAGTAGAAGGCTAAACAGCTGTACCATTGTAGTTCACTCTTCTATGTCAAC	ATGTCACTGCACTCCAGACTTGGCAATAGAGCAAGACCCTGCTTCAAAAAAAGGGTCTGTTTTTGAGACCCCATATATATATTTAAAAAAATTTAAAAGTAGAAGGCTAAACAGCTGTACCATTGTAGTTCACTCTTCTATGTCAAC
AGACTTTGTCTCTACAAATAAAATAAAATATTAGTTGGGTGTGTTGGTGTGTGCCTGTAGTCGCAGCTGTTTTGGAGGCTGAGGTGGGAGGATCACTTGAGCCCAGGAGTTCAAGGTTACAGTGAGCTATGATTGTGCCACTGTACA	AGACTTTGTCTCTACAAATAAAATAAAATATTAGTTGGGTGTGTTGGTGTGTGCCTGTAGTCGCAGCTGTTTCGGAGGCTGAGGTGGGAGGATCACTTGAGCCCAGGAGTTCAAGGTTACAGTGAGCTATGATTGTGCCACTGTACA
TGTTTTATTTGCTGTTTTCAGGATAATGCATTTTCTTCCCTCTGTAACCATTGATCTATTAATGAAGTTTTTAAAAAAAAAAGTATCGTAAGCTTATGAATTTATATATTTGACTTTTAAAAATCAATTTGCAGTATTTTTTACATG	TGTTTTATTTGCTGTTTTCAGGATAATGCATTTTCTTCCCTCTGTAACCATTGATCTATTAATGAAGTTTTTTAAAAAAAAAGTATCGTAAGCTTATGAATTTATATATTTGACTTTTAAAAATCAATTTGCAGTATTTTTTACATG
TTTGGTAGAGAGTGTCTGAATATGTTGCCCAGGCTGGTCTTGAACTTCTGGCCTCAAGCAATTCTTTCACTTTAGCCTCCCAAAGTGTTGGGATTATAGGCGTGAGGAACCATGCCTGGCCCCAATTTATGTTTTTTATTTAATGCT	TTTGGTAGAGAGTGTCTGAATATGTTGCCCAGGCTGGTCTTGAACTTCTGGCCTCAAGCAATTCTTTCACTTCAGCCTCCCAAAGTGTTGGGATTATAGGCGTGAGGAACCATGCCTGGCCCCAATTTATGTTTTTTATTTAATGCT
TGAATAAAGTATTAGTATATGAGAGGTAAGGGAACTACTGACTGCAACATAGGGGCAGAATGAAATAAATGGGAAAGTGAGGAATCAGTCGAATAATTTTATGGAGCAAAGGAAAAAAAAGGTATGCCCTTTTACTCAGAAAAGCAG	TGAATAAAGTATTAGTATATGAGAGGTAAGGGAACTACTGACTGCAACATAGGGGCAGAATGAAATAAATGGAAAAGTGAGGAATCAGTCGAATAATTTTATGGAGCAAAGGAAAAAAAAGGTATGCCCTTTTACTCAGAAAAGCAG
CTCGAACTCCTGACCTCAAATGATCTGTCCGCTTCGGCCTCCCAAAGGGCTGGGATTACAGGCATGAGCTATTGCGCCCGGCCTCCTTTTCTAATATATGATTCATTTTGAACTTCCACAGCGTGGCCCATGGTTAACTTTTATTCA	CTCGAACTCCTGACCTCAAATGATCTGTCCGCTTCGGCCTCCCAAAGGGCTGGGATTACAGGCATGAGCTATCGCGCCCGGCCTCCTTTTCTAATATATGATTCATTTTGAACTTCCACAGCGTGGCCCATGGTTAACTTTTATTCA
TGAACTCCTGACCTCAAGTGATCCACCCACCTTGGCCTCCCAGAGTGCTGGGATTACAGGCATGTGCCACTGTGCCTAGCCAGATAGTAGTTAAAACATTTGGGGAGCATGACTGAGCCTGTTTAGCCATATTGGAGATTAAAAATC	TGAACTCCTGACCTCAAGTGATCCACCCACCTTGGCCTCCCAGAGTGCTGGGATTACAGGCATGTGCCACTGCGCCTAGCCAGATAGTAGTTAAAACATTTGGGGAGCATGACTGAGCCTGTTTAGCCATATTGGAGATTAAAAATC
TTTATTGCTTTTTTTCTTTCTTTCTTTTTTTTTTTGAGACAGGATCTCACTCTGTCATTGAGGCTCGAGTGCTGTGGTGCAATCATAGCTCACTGTAGCCTTGACCTTCCAGGCTCAATTGATCTTCCCACTCAGCCTCCCAAGCAG	TTTATTGCTTTTTTTCTTTCTTTCTTTTTTTTTTTGAGACAGGATCTCACTCTGTCATTGAGGCTCGAGTGCAGTGGTGCAATCATAGCTCACTGTAGCCTTGACCTTCCAGGCTCAATTGATCTTCCCACTCAGCCTCCCAAGCAG
GGTCTCAAACTCCTGGGCTCAAGTGATCCTCCTACCTCAGCCTCCCAAAGTGCTGAGATTACAAGTGTGAGCTACTGTGCTCAGCTGACATAATCTTTTGATGTATGAATGGACCCATCTCTCTTGCTGCCCCTGCAACACCAGATA	GGTCTCAAACTCCTGGGCTCAAGTGATCCTCCTACCTCAGCCTCCCAAAGTGCTGAGATTACAAGTGTGAGCCACTGTGCTCAGCTGACATAATCTTTTGATGTATGAATGGACCCATCTCTCTTGCTGCCCCTGCAACACCAGATA
AGTGATTTTTATGAATTAGGCACCTGTGAGGTAGATGTTACTCTGCCCATTTTACACTCAAAGAACCTGGGCTTAGGAGGGTTCAGATTTGCCTACGACTGCACAGCTGGTAGGTGGTAGAGCCAGAATTCAAGTTCAGATTTGTCT	AGTGATTTTTATGAATTAGGCACCTGTGAGGTAGATGTTACTCTGCCCATTTTACACTCAAAGAACCTGGGCCTAGGAGGGTTCAGATTTGCCTACGACTGCACAGCTGGTAGGTGGTAGAGCCAGAATTCAAGTTCAGATTTGTCT
AAAAATTATAATTATTCCGTTCAGAGAATTGGCCTGTCATTTTTTCCTTGTGCTTTGACCTTATCAAAAATTAGGTCTTGTTTTTTTATCCCAGAACTCATGTTTTAAAATGGAATGCCAGGCACAGTGGCTCACTCCTATAGTCCC	AAAAATTATAATTATTCCGTTCAGAGAATTGGCCTGTCATTTTTTCCTTGTGCTTTGACCTTATCAAAAATTGGGTCTTGTTTTTTTATCCCAGAACTCATGTTTTAAAATGGAATGCCAGGCACAGTGGCTCACTCCTATAGTCCC
ACACTCCAGCCTGGCGACAGAGCTAGACTCCGTCTCTAAATAAATAAATAAATAAATAAATAAATAAAGTGCGGTAGCATGATCATAGCTCACTGCAACCTTGAATTCCTGGGCTCAAGCAGTCCTCCCTCCTCAGCCTCCCGAATA	ACACTCCAGCCTGGCGACAGAGCTAGACTCCGTCTCTAAATAAATAAATAAATAAATAAATAAATAAAGTGCAGTAGCATGATCATAGCTCACTGCAACCTTGAATTCCTGGGCTCAAGCAGTCCTCCCTCCTCAGCCTCCCGAATA
TTTTTTTTTTTTTTTTTTTTTTTTTAGACAGTCTCACTCTTGTCACCCAAGCTGGAGTGTAATGACATGATCGTGGCCCACTGTAACCTTGAACTCTTGGGCTCAAGTGATCTTTCCAGCTCAGCCTCCTGAGTATCTGAGACTACA	TTTTTTTTTTTTTTTTTTTTTTTTTAGACAGTCTCACTCTTGTCACCCAAGCTGGAGTGTAATGACATGATCATGGCCCACTGTAACCTTGAACTCTTGGGCTCAAGTGATCTTTCCAGCTCAGCCTCCTGAGTATCTGAGACTACA
TATGATCTACTTTATGGAAAATTACATGAGTGTGTATGCAGTAAAAGTATGAAAAGTTGGTGACCAAAATGTGAATAGTGGTTATCTTATTTCAGTGGAATTTCAGGGGATTTTTTTTCTTTCTTCTTAGACTTTTCATTATCATTT	TATGATCTACTTTATGGAAAATTACATGAGTGTGTATGCAGTAAAAGTATGAAAAGTTGGTGACCAAAATGTTAATAGTGGTTATCTTATTTCAGTGGAATTTCAGGGGATTTTTTTTCTTTCTTCTTAGACTTTTCATTATCATTT
ACAGATCGTGGGAAAATAGTTTTCAAAGTCTAACACTGTGATAGATAACTAGCTGGAATCCAACTCTTCTCACCCCTTGTACCACTACCCTCCTTTGTAGCCTGGCTTGTCACCATCTTCCTCGTTCCCTGCTTTTGCCCTTGCTCA	ACAGATCGTGGGAAAATAGTTTTCAAAGTCTAACACTGTGATAGATAACTAGCTGGAATCCAACTCTTCTCAGCCCTTGTACCACTACCCTCCTTTGTAGCCTGGCTTGTCACCATCTTCCTCGTTCCCTGCTTTTGCCCTTGCTCA
CTCATTTCAAAATAAAAGCCAAAGCCTTTACATTGTTCTACCCACACCAAATTCATGAAGGGATGACACATAGAGTATGCAACCTATGCATGTTTGCTTGTTCTTTTTAAAAAGGTGGTCTTTACAGCTATAGACTCCTCTCTCCTG	CTCATTTCAAAATAAAAGCCAAAGCCTTTACATTGTTCTACCCACACCAAATTCATGAAGGGATGACACATACAGTATGCAACCTATGCATGTTTGCTTGTTCTTTTTAAAAAGGTGGTCTTTACAGCTATAGACTCCTCTCTCCTG
ATGGCTAACTTGAATGAAGTATAGAGAAGACCTTAAATGATCCGATGTTGCTGAAAACCATGGCATGGGAACTATGTGAGGCATGCACAAGCTTCAATAGCCAATTCAATCAAGTGGAAGAAAGGGTAACCGTGATTGAAGATCAAA	ATGGCTAACTTGAATGAAGTATAGAGAAGACCTTAAATGATCCGATGTTGCTGAAAACCATGGCATGGGAACCATGTGAGGCATGCACAAGCTTCAATAGCCAATTCAATCAAGTGGAAGAAAGGGTAACCGTGATTGAAGATCAAA
ATTTTTAAAAAGCAAGAAAACAAACTCAATTTAAAAATGGGCCAAATACCATAATAGATGTCTCACCAAAGAAGATATATAGATGAAAAATAGGCATATGAAAAGATGCTCCACATCATACGTGGTCAGGGAAATGCATACTAAAAT	ATTTTTAAAAAGCAAGAAAACAAACTCAATTTAAAAATGGGCCAAATACCATAATAGATGTCTCACCAAAGACGATATATAGATGAAAAATAGGCATATGAAAAGATGCTCCACATCATACGTGGTCAGGGAAATGCATACTAAAAT
ACTGAGAAATGTGTTAAAGTGTCCTACTACTGGTCATTTTTTTTTGTATTTATAATTTTTACTTTATATGTTCAGTTAATATTACTTGGTACATACTGACCCATGAGTGTTCAATTGAAATTGTCACTTTATAGTATTACAATATTT	ACTGAGAAATGTGTTAAAGTGTCCTACTACTGGTCATTTTTTTTTGTATTTATAATTTTTACTTTATATGTTGAGTTAATATTACTTGGTACATACTGACCCATGAGTGTTCAATTGAAATTGTCACTTTATAGTATTACAATATTT
ACTGCCATAGAAGTCTTTGAAGCTGAAATAAAATTGTCAACTTTTGATTTTGCTAAATAAGTATATATTAAATAAAGGTCCATAACCACCATACACATCATCATCATTTTATAAAACATAAAACACTCCTCCCCATATGATTTGAAA	ACTGCCATAGAAGTCTTTGAAGCTGAAATAAAATTGTCAACTTTTGATTTTGCTAAATAAGTATATATTAAACAAAGGTCCATAACCACCATACACATCATCATCATTTTATAAAACATAAAACACTCCTCCCCATATGATTTGAAA
ATAATGAGAGTTTTCTTTCATTTTTTTCCACATGTCTACCAAATTCCAATAACATTTACTGAACATCTTATTCTTTTACCACTGCTCTGCTGGGCCAGCTCTGTCATAAATCAAGTGTTCCTTTGTGGGTGGGCTTGTTTCTGGACT	ATAATGAGAGTTTTCTTTCATTTTTTTCCACATGTCTACCAAATTCCAATAACATTTACTGAACATCTTATTTTTTTACCACTGCTCTGCTGGGCCAGCTCTGTCATAAATCAAGTGTTCCTTTGTGGGTGGGCTTGTTTCTGGACT
TCTCTTAATGACATTCTCCATACTTATAAACCTTAGAAAAGAAACAAAGTAGTAGCTATTGACTACATGATACACTGTCTACCCACCCGTAGTAATAACAGCTACCAATTTTGAGCAACCTGTGCTGTGCCTATACCTTACATAGAT	TCTCTTAATGACATTCTCCATACTTATAAACCTTAGAAAAGAAACAAAGTAGTAGCTATTGACTACATGATATACTGTCTACCCACCCGTAGTAATAACAGCTACCAATTTTGAGCAACCTGTGCTGTGCCTATACCTTACATAGAT
TCAAGGCATCTTAAGTATATCAGGAGAAGAACCCAAAACATCTCATCTTCATGTATGAAAAGTTAAATGTTTGGCCACAATCATTCATATTTCCTTCAAGATACATTTTAGGCCAACATTTGAATAGTCGAAGATGATTCTGTAAAT	TCAAGGCATCTTAAGTATATCAGGAGAAGAACCCAAAACATCTCATCTTCATGTATGAAAAGTTAAATGTTTAGCCACAATCATTCATATTTCCTTCAAGATACATTTTAGGCCAACATTTGAATAGTCGAAGATGATTCTGTAAAT
CCCGGCCCCTTCTACGCTACTGAATATCAGAATTTATTCCTTTTATCTAACTGTATCTTTGTATCCATTAACCAACTTTCTCTTATCCCCCTGCCCTGCTTCCTTTCCTAGCCTCTGGTAACTACCATTCGACTGTCTGCCTCTAAG	CCCGGCCCCTTCTACGCTACTGAATATCAGAATTTATTCCTTTTATCTAACTGTATCTTTGTATCCATTAACGAACTTTCTCTTATCCCCCTGCCCTGCTTCCTTTCCTAGCCTCTGGTAACTACCATTCGACTGTCTGCCTCTAAG
AGCCATCCTAATCATCCAAGATGATTACAGATACAAAATATCCATATTAATGATATTTACATTATATGGTACATCACATTATATGACACTGAATATAATAGCTGGATTGACTGTATTGTACTTCTAAAGAAAAATACCCATTGGAAA	AGCCATCCTAATCATCCAAGATGATTACAGATACAAAATATCCATATTAATGATATTTACATTATATGGTACGTCACATTATATGACACTGAATATAATAGCTGGATTGACTGTATTGTACTTCTAAAGAAAAATACCCATTGGAAA
TGCAACCTCCACCTCCCGGGTTCAAGCGATTCTCCTGCCTCAGCCTCCTGAGTAGCTGGGACTATGGGCGTGCGCCATTATGCCCAGCTAATTTTTGTATTTTTAGTAGGGACAGGGTTTTATCATATTGGCCAGGCTGGTCTTGAA	TGCAACCTCCACCTCCCGGGTTCAAGCGATTCTCCTGCCTCAGCCTCCTGAGTAGCTGGGACTATGGGCGTGTGCCATTATGCCCAGCTAATTTTTGTATTTTTAGTAGGGACAGGGTTTTATCATATTGGCCAGGCTGGTCTTGAA
GTATATTATCTATAGCTCTAGATTCTCATCCTAGAGCCATGTAAATTTGGGATGATGGGTGTGACGACTTTGGTGCCTTTCTTACAGAAGGAGGTTGCTGAAGAAAGCTAAGTGCAGCACTTCTCTGTGAGGCTGGAGGACAGAGAA	GTATATTATCTATAGCTCTAGATTCTCATCCTAGAGCCATGTAAATTTGGGATGATGGGTGTGACGACTTTGATGCCTTTCTTACAGAAGGAGGTTGCTGAAGAAAGCTAAGTGCAGCACTTCTCTGTGAGGCTGGAGGACAGAGAA
GTATGCAGAATTAAGTATTGCCCAGGTAGTTTAAAACTTCTATTACATTTCCTAGACCTAGTGAAGAAATCAGTCATTTTCCAGTTGGTTAATGTCAATTGAGACGTTCGTATGAACGATCATATGAGGCACCATTAAGGGTTCACC	GTATGCAGAATTAAGTATTGCCCAGGTAGTTTAAAACTTCTATTACATTTCCTAGACCTAGTGAAGAAATCAATCATTTTCCAGTTGGTTAATGTCAATTGAGACGTTCGTATGAACGATCATATGAGGCACCATTAAGGGTTCACC
CTCAGCACATTTGTAACATATTCACAGGGGCTTGCATGTATTTTGTGGAAAAATCTGTCATAAACTAAGGCACTTTAAACTACATTCATTCAACTTAAAATAATAGCAAAACAACACACCTTCTCAAGTCTTGTCCATCCCTTTCCC	CTCAGCACATTTGTAACATATTCACAGGGGCTTGCATGTATTTTGTGGAAAAATCTGTCATAAACTAAGGCAATTTAAACTACATTCATTCAACTTAAAATAATAGCAAAACAACACACCTTCTCAAGTCTTGTCCATCCCTTTCCC
AATGGCTAGACAACTCGCGTTTTAAATTTATGGTCCAAGTATATATGAATACTTCATCCGGAATTGGAAACACATTGTGTCACCCATCGTGCTCAGCTTCATCGAGTTAAATGCCTGAAGGCCCTATATGTTAGTAAATGCCCCAAT	AATGGCTAGACAACTCGCGTTTTAAATTTATGGTCCAAGTATATATGAATACTTCATCCGGAATTGGAAACAGATTGTGTCACCCATCGTGCTCAGCTTCATCGAGTTAAATGCCTGAAGGCCCTATATGTTAGTAAATGCCCCAAT
CTTTTTGTATTAGTTATATAAAAACAAAGCAGTAAGGAACAGGGCTCTCGTCTGCTTTGTATCAGTGTAAGTTCTTCTTCTGAACATTCTGCAAGCGAGAGGACTGGGAGAAGATAAATGCACAGGACACAGAGGGCTGTATTTTCT	CTTTTTGTATTAGTTATATAAAAACAAAGCAGTAAGGAACAGGGCTCTCGTCTGCTTTGTATCAGTGTAAGTCCTTCTTCTGAACATTCTGCAAGCGAGAGGACTGGGAGAAGATAAATGCACAGGACACAGAGGGCTGTATTTTCT
AAAAGTGAAAGAGTCTAAAGTTTAGAAGGGGTTGTTAGTGATTTAGTGATGACCTAAACAAGCAAATGTGGATTTTTCAATGAAAACCTCTTTGCAGGGGTGGTTGAGGTCATGTTAGCCAGTAATCTTTTGCCAGGGATCTTAGGT	AAAAGTGAAAGAGTCTAAAGTTTAGAAGGGGTTGTTAGTGATTTAGTGATGACCTAAACAAGCAAATGTGGACTTTTCAATGAAAACCTCTTTGCAGGGGTGGTTGAGGTCATGTTAGCCAGTAATCTTTTGCCAGGGATCTTAGGT
TTTGAGATGGGAATTCTGGGGAGAAATACAGGACAGGAGAGTAAAATAGAAAAGGAGAGAAAGACGATACAATGATGCATTACTGAGCTGTCCACCACTATAAATACCTGGTGCTTGATTCTGCAGGGACCTTCTGAGAGCCTTCTG	TTTGAGATGGGAATTCTGGGGAGAAATACAGGACAGGAGAGTAAAATAGAAAAGGAGAGAAAGACGATACAACGATGCATTACTGAGCTGTCCACCACTATAAATACCTGGTGCTTGATTCTGCAGGGACCTTCTGAGAGCCTTCTG
CAGGGCAAAGGGATGAGGGGGTTGACATCAACATCTCAGCACATTTGTAACATATTCACAGGGGCTTGCATGCATTTTGTGGAAAAATCTGTCATAAACTAAGGCAATTTAAACTACATTCATTCAACTTAAAATAATAGCAAAACA	CAGGGCAAAGGGATGAGGGGGTTGACATCAACATCTCAGCACATTTGTAACATATTCACAGGGGCTTGCATGTATTTTGTGGAAAAATCTGTCATAAACTAAGGCAATTTAAACTACATTCATTCAACTTAAAATAATAGCAAAACA
GGTGATCTCACAGATAGGCTACCCAGCTGAGCACAGGGCAAGCTCAGCTTAAGGATGAGTATCTGAAAAGAAGCAGAAATGTTCTGTTTTTCTAATTCATTGAGAATTACTTTTACAAAGGTGACATATTTGCTTTTAATCCCCAAA	GGTGATCTCACAGATAGGCTACCCAGCTGAGCACAGGGCAAGCTCAGCTTAAGGATGAGTATCTGAAAAGAAACAGAAATGTTCTGTTTTTCTAATTCATTGAGAATTACTTTTACAAAGGTGACATATTTGCTTTTAATCCCCAAA
GCCTAAGAGTGTAAATTCTGAAATTCTGACACCAGAAAGTCTTGTTTCAAAGCTAGCTTCCATCACTTACCCACCTGTGCAATCTTGACCTGGTCACTTTACCTCTCTGGACCTGTAAAATGGTGATAATCATCACATCCATTTTAT	GCCTAAGAGTGTAAATTCTGAAATTCTGACACCAGAAAGTCTTGTTTCAAAGCTAGCTTCCATCACTTACCCGCCTGTGCAATCTTGACCTGGTCACTTTACCTCTCTGGACCTGTAAAATGGTGATAATCATCACATCCATTTTAT
TGTGAACTTCCTTTTGATAGTTTGGATGCAAAAATTAAATATATTATAAACGTGAATAAACTTCACCTTATCTTTAACAAGCTAGATACTGGAACTTAGAGATATTAAAATAGTGAATTCAGAAAACTTAGGGCTTTCAGTCTTCAA	TGTGAACTTCCTTTTGATAGTTTGGATGCAAAAATTAAATATATTATAAACGTGAATAAACTTCACCTTATCCTTAACAAGCTAGATACTGGAACTTAGAGATATTAAAATAGTGAATTCAGAAAACTTAGGGCTTTCAGTCTTCAA
CATGGGACTCTGATACAATAGGAGTTTTGTAACAGACGGCAAAAAGTCCAAGCCTGCTTTCTTCCCTTTTCTTCAATGGATGAACAAACCCAAGGCAGAATAATCTTTGCAACAACTCGGCAGAGAGAGGCAGCAGTGCCTGATGGA	CATGGGACTCTGATACAATAGGAGTTTTGTAACAGACGGCAAAAAGTCCAAGCCTGCTTTCTTCCCTTTTCTGCAATGGATGAACAAACCCAAGGCAGAATAATCTTTGCAACAACTCGGCAGAGAGAGGCAGCAGTGCCTGATGGA
TTCTTTCTTTCTTTCTTTTTTTTTTTTCTGAGATGGAGTTTCGCTCTTGAAGCCCAGGCTGGAGGGCAATGGTGCAATCTCAATTCACCGCAACCACCGCCTCCTGGGTTCAAGCGATTCACCTGCCTCAGCCTCCCGAGTAGCTGG	TTCTTTCTTTCTTTCTTTTTTTTTTTTCTGAGATGGAGTTTCGCTCTTGAAGCCCAGGCTGGAGGGCAATGGCGCAATCTCAATTCACCGCAACCACCGCCTCCTGGGTTCAAGCGATTCACCTGCCTCAGCCTCCCGAGTAGCTGG
CCGGTCTCCCAAAGTGCTGGGATTACAGTCACATTCATTGTTTCAGAGGGTGGATACAGACTTTCCTAATAAGGAAAGATTTCTTTAGCTCTTAGGCTAAAACACTTACAGAGGTGAGGAAACACTTTTCATCCCTGAGTTTATCAA	CCGGTCTCCCAAAGTGCTGGGATTACAGTCACATTCATTGTTTCAGAGGGTGGATACAGACTTTCCTAATAAAGAAAGATTTCTTTAGCTCTTAGGCTAAAACACTTACAGAGGTGAGGAAACACTTTTCATCCCTGAGTTTATCAA
GGGAAGCTCCCAACTCTTCTGCTTCCTTTCTGACTCCTCTCTCCCTCCCCCTTAGCCCGTGGAAGCTTCATGTTTCTTAGGGCCCCTTCCTCAGAAGCTGGATGTGGAGAAGAAAGGCAAGGATGTGTCATTTCAGGAATATAGATG	GGGAAGCTCCCAACTCTTCTGCTTCCTTTCTGACTCCTCTCTCCCTCCCCCTTAGCCCGTGGAAGCTTCATGCTTCTTAGGGCCCCTTCCTCAGAAGCTGGATGTGGAGAAGAAAGGCAAGGATGTGTCATTTCAGGAATATAGATG
ATCTGTTCTATTCATGTCCTCTTCTGCCCCGAAAGCCCACAGAATTTTTTGCCAACATGGTCCTAATCCTTATGTCTGAATTTCTGACACAGTTCCATGGATATTTACACGCCCTTAACCTAATTAAAGCAGGGGCATTTCTCTTCT	ATCTGTTCTATTCATGTCCTCTTCTGCCCCGAAAGCCCACAGAATTTTTTGCCAACATGGTCCTAATCCTTACGTCTGAATTTCTGACACAGTTCCATGGATATTTACACGCCCTTAACCTAATTAAAGCAGGGGCATTTCTCTTCT
CTGAATGGATTCAGTGGAGGCAGAGGCAGAATGTCTAGACTGAGGAAACCATGAGAAAGTGAGCCTTCCAGGGGTTCACAGAAATTGTGGAAGGTTTTAAAGACAAACCTCATCTAGATTTTTTTTTTTTTTTTGAGACAGAGTCTT	CTGAATGGATTCAGTGGAGGCAGAGGCAGAATGTCTAGACTGAGGAAACCATGAGAAAGTGAGCCTTCCAGGTGTTCACAGAAATTGTGGAAGGTTTTAAAGACAAACCTCATCTAGATTTTTTTTTTTTTTTTGAGACAGAGTCTT
TCTCATTTAAAATGAGTGTGCACACCACAGTTCCATAGCCCAAGGAAGAAATATAGTTCTAAAACAGTGAACGAGATCAACAATCCAAACAGCAGCTCACCTGAGATGAAATCACTGTAATAGGATAGTGTGGAAAGTACTTTTAAA	TCTCATTTAAAATGAGTGTGCACACCACAGTTCCATAGCCCAAGGAAGAAATATAGTTCTAAAACAGTGAACAAGATCAACAATCCAAACAGCAGCTCACCTGAGATGAAATCACTGTAATAGGATAGTGTGGAAAGTACTTTTAAA
GGGAAGAAGCTAAATAAGAATGTGCTCTGTATTAGGGTTCTCCAGAGAATCAGAACTAATAGGATATATACCTATATCCACATCTATATCTATATCATTAATCTATCTGTATCTATATCCATATCTATAGCTGTGTCTCTATTATCT	GGGAAGAAGCTAAATAAGAATGTGCTCTGTATTAGGGTTCTCCAGAGAATCAGAACTAATAGGATATATACCCATATCCACATCTATATCTATATCATTAATCTATCTGTATCTATATCCATATCTATAGCTGTGTCTCTATTATCT
GTTTATTTTACTATGAGCGTCTCCTTAAAAGATCAGGAATTTTTTAATGCAATACCCAATTTGTAAAGCCCACGTTAGATTATAGAACTTAGTTATGAGGACATACTGATCAACTGCTAAAAATGGTCACATTAAAAGGGACTGTAG	GTTTATTTTACTATGAGCGTCTCCTTAAAAGATCAGGAATTTTTTAATGCAATACCCAATTTGTAAAGCCCAAGTTAGATTATAGAACTTAGTTATGAGGACATACTGATCAACTGCTAAAAATGGTCACATTAAAAGGGACTGTAG
TAACATTCACGCACCACCATGCCCAGCTAGCTTTTGTATTTTTAGTAGAAACAGGGTTTCACGGTGTTGGTCATGTTGGTTGAACTCCTGACCTCGTGATCTGCCTGCCTCAGCCTCCCAAAGTGCTGGGATTACAGGCGTGAGCCA	TAACATTCACGCACCACCATGCCCAGCTAGCTTTTGTATTTTTAGTAGAAACAGGGTTTCACGGTGTTGGTCCTGTTGGTTGAACTCCTGACCTCGTGATCTGCCTGCCTCAGCCTCCCAAAGTGCTGGGATTACAGGCGTGAGCCA
TAATTGTTAAAATCTTCTACTTGAATCCAAAGAACAATAACTGATTTGCTATCTGAAAAATGAACCTTTGCTCTCACTATAGGCTGATTAATTCACAAATAAAGTTAAGTGTAGGTCTTTCTCTTGGTCTTACCTGAGAAACTACAG	TAATTGTTAAAATCTTCTACTTGAATCCAAAGAACAATAACTGATTTGCTATCTGAAAAATGAACCTTTGCTGTCACTATAGGCTGATTAATTCACAAATAAAGTTAAGTGTAGGTCTTTCTCTTGGTCTTACCTGAGAAACTACAG
ATGCAGAAATTTACATAAGTAACAAGGAGTCAAATGTTAATCCCCAAGACAATGGGGAAAATGTGTCCAGGGCATTTCAGAGGTCTTCATGGCAGCCCCTCCCATCACAGGCCCAGAGATCTAGGAAGAAAAAATGGTTTCATGGGC	ATGCAGAAATTTACATAAGTAACAAGGAGTCAAATGTTAATCCCCAAGACAATGGGGAAAATGTGTCCAGGGAATTTCAGAGGTCTTCATGGCAGCCCCTCCCATCACAGGCCCAGAGATCTAGGAAGAAAAAATGGTTTCATGGGC
AATGTTATGGTTTGGCTCAGTGTCCCCACCAAAATCTCATCTTGAATTGTACTCCCACAATGCCCAAATGTTGTGGGAGGGACGCAGTGGGAGATAATTTGAATTATGAGGGTGGTTTCTCCCATACTGTTCTCATGGTAGTGAATA	AATGTTATGGTTTGGCTCAGTGTCCCCACCAAAATCTCATCTTGAATTGTACTCCCACAATGCCCAAATGTTATGGGAGGGACGCAGTGGGAGATAATTTGAATTATGAGGGTGGTTTCTCCCATACTGTTCTCATGGTAGTGAATA
CCAGTCTTGGGTATATCTTTATCAGCAGCATGAAAATGGACTAATACATTGGTACCCTCCAGAATCCATTTCGAATTCCCTCTTCCTGGCAGCCTCTAGTTTCTGTCTGTGTATCCTCCAGTTCAACAGAAGCTCTAGGGGTAGAGC	CCAGTCTTGGGTATATCTTTATCAGCAGCATGAAAATGGACTAATACATTGGTACCCTCCAGAATCCATTTCAAATTCCCTCTTCCTGGCAGCCTCTAGTTTCTGTCTGTGTATCCTCCAGTTCAACAGAAGCTCTAGGGGTAGAGC
CCAGGGTCATAAAAATATTCTCCTATATTTTCTCTTAAAGGCATTATGGTTTTGCTTTCTTGTAGTTGTCTTTAATCTGTCTGGAAATGACTTTGGTACATAGGAGGAAGAAGTTTAATTATATGTTTTTCTTTGTATACAAATAAT	CCAGGGTCATAAAAATATTCTCCTATATTTTCTCTTAAAGGCATTATGGTTTTGCTTTCTTGTAGTTGTCTTCAATCTGTCTGGAAATGACTTTGGTACATAGGAGGAAGAAGTTTAATTATATGTTTTTCTTTGTATACAAATAAT
TGCTTTCTTGTAGTTGTCTTCAATCTGTCTGGAAATGACTTTGGTACATAGGAGGAAGAAGTTTAATTATATATTTTTCTTTGTATACAAATAATTTTTTCTATTGAGTAGTCAATTGTTACTCTTCTGATTTGCCACACCTCTTTC	TGCTTTCTTGTAGTTGTCTTCAATCTGTCTGGAAATGACTTTGGTACATAGGAGGAAGAAGTTTAATTATATGTTTTTCTTTGTATACAAATAATTTTTTCTATTGAGTAGTCAATTGTTACTCTTCTGATTTGCCACACCTCTTTC
GTATTTTTATGCATATTGCTGTGTTTGGCTAATACTTTATTTAGAGCTGTTGCATCAACATTCTTAATGAGACAGATTGCAGTTTTCCTTTCTTGTATTGTCCTTTTCTCTTTTTGGTATCATACTTAGTAGACATGTAAAATGAAT	GTATTTTTATGCATATTGCTGTGTTTGGCTAATACTTTATTTAGAGCTGTTGCATCAACATTCTTAATGAGAGAGATTGCAGTTTTCCTTTCTTGTATTGTCCTTTTCTCTTTTTGGTATCATACTTAGTAGACATGTAAAATGAAT
TTTTCACAGTGGCAGATAGTATATATTTGAATTCTAAACATATCTGAGGGCAGGCCCAATTTCACAAACTCAGAGGGACCTTGTAGAGTTCAAAGAGAGACATGATTGCTTCCTACCTCTTTGTGCTAGGGCAGAGTGGGATTGTAC	TTTTCACAGTGGCAGATAGTATATATTTGAATTCTAAACATATCTGAGGGCAGGCCCAATTTCACAAACTCAAAGGGACCTTGTAGAGTTCAAAGAGAGACATGATTGCTTCCTACCTCTTTGTGCTAGGGCAGAGTGGGATTGTAC
AAAGAGAGTTGTGGAGGTAACCATCACAGTCTTGAAATAGACGTCTAGGGCCCCTTACACCCGATCCGACTAGGCGCTGCAGGAGTCCACTGGCCCGTTATAACCGTGATCCCTCTTGCCGCCCAGCTTCCCTCCGTTAGGGATTTC	AAAGAGAGTTGTGGAGGTAACCATCACAGTCTTGAAATAGACGTCTAGGGCCCCTTACACCCGATCCGACTAAGCGCTGCAGGAGTCCACTGGCCCGTTATAACCGTGATCCCTCTTGCCGCCCAGCTTCCCTCCGTTAGGGATTTC
TTGCTCTGCAGAGATTACAGTGGAAGCTTCTTAAGTCGTAATGTAGGGTTTCACATAGCTTTCAATTGTAATCATTAAAATTCTTATGTTAAATAACTAATGCCAGAATAATTCTGAATTAATTTATATTTTCTTTAATATTCTTCT	TTGCTCTGCAGAGATTACAGTGGAAGCTTCTTAAGTCGTAATGTAGGGTTTCACATAGCTTTCAATTGTAATAATTAAAATTCTTATGTTAAATAACTAATGCCAGAATAATTCTGAATTAATTTATATTTTCTTTAATATTCTTCT
TATAGTCAACTGTTTTCATTTTTTTACTTCATGGTTTAGGTTTTTTTGTTAGAAATTTTTCTGTATTCCAGGTTCATAAAAATATTCTCCTATATTTTCTCTTAAAGGCATTATGGTTTTGCTTTCTTGTAGTTGTCTTCAATCTGT	TATAGTCAACTGTTTTCATTTTTTTACTTCATGGTTTAGGTTTTTTTGTTAGAAATTTTTCTGTATTCCAGGGTCATAAAAATATTCTCCTATATTTTCTCTTAAAGGCATTATGGTTTTGCTTTCTTGTAGTTGTCTTCAATCTGT
TATGATCTCATGTATGTGAATTTGGACAACGAAATAGACAATGGACTCCATCCCACTGAGGACCGTAAGTTCGCTTTAACTGTTTCTCTGCTAACCCTGACTACATATCCACCTCTTGGTCTAAATAACACACATATACTTTGTGGC	TATGATCTCATGTATGTGAATTTGGACAACGAAATAGACAATGGACTCCATCCCACTGAGGACCGTAAGTTCACTTTAACTGTTTCTCTGCTAACCCTGACTACATATCCACCTCTTGGTCTAAATAACACACATATACTTTGTGGC
CTCAGGGCAAAGAGCATGCTTAGAAGGTAGGCTCAAGAGTGCCCAATACTGCAAGGACTGAAGTACCCACGGGTAGCAACAAAGAGGTTCAAGGCAGTTTCAGCAGAGTTACTGGGGCAGAAATAAAATCACAGTGGACTGAAAGAG	CTCAGGGCAAAGAGCATGCTTAGAAGGTAGGCTCAAGAGTGCCCAATACTGCAAGGACTGAAGTACCCACGGATAGCAACAAAGAGGTTCAAGGCAGTTTCAGCAGAGTTACTGGGGCAGAAATAAAATCACAGTGGACTGAAAGAG
TTAAGGAGGTGGGTGTATTTACTATAAAAATAGGATTCCAGGAACATCTTTCACAAGTTTGAGAGAGGAAAAGGGTGGAGGCTGAGTGAGAACAAATAAAGAGCAAAGTAGAATGGGGATGGGACAACCAGAGAGAGGGGCTTCTTT	TTAAGGAGGTGGGTGTATTTACTATAAAAATAGGATTCCAGGAACATCTTTCACAAGTTTGAGAGAGGAAAAAGGTGGAGGCTGAGTGAGAACAAATAAAGAGCAAAGTAGAATGGGGATGGGACAACCAGAGAGAGGGGCTTCTTT
TATTAATGTACATCTGTCAGGGTAGAAAGATAAAACAGATTTTATTTAATAGTTTACCTTGATTTATAATGTCTAAATATATAGACATGGCTGGGCACAGTGGCTTACACCTGTAATCCCAGCACTTTGGGAGGCTGAGGTGGGCAG	TATTAATGTACATCTGTCAGGGTAGAAAGATAAAACAGATTTTATTTAATAGTTTACCTTGATTTATAATGTTTAAATATATAGACATGGCTGGGCACAGTGGCTTACACCTGTAATCCCAGCACTTTGGGAGGCTGAGGTGGGCAG
CCTGAGAATCTGCACAGGTGAGGGGTGTGCCTGAATGATGGAGTCAGCTGCTAAGAGGCCAGAGGAGGGGTTATTAGACTTCTGGTCAATATGGCAGAGTAAACACTTGCTGAAAATCCTTAGGCCTCTGCAACATACAGAAATAAC	CCTGAGAATCTGCACAGGTGAGGGGTGTGCCTGAATGATGGAGTCAGCTGCTAAGAGGCCAGAGGAGGGGTTTTTAGACTTCTGGTCAATATGGCAGAGTAAACACTTGCTGAAAATCCTTAGGCCTCTGCAACATACAGAAATAAC
TGCACAGGTGAGGGGTGTGCCTGAATGATGGAGTCAGCTGCTAAGAGGCCAGAGGAGGGGTTTTTAGACTTCCGGTCAATATGGCAGAGTAAACACTTGCTGAAAATCCTTAGGCCTCTGCAACATACAGAAATAACAGATACACTA	TGCACAGGTGAGGGGTGTGCCTGAATGATGGAGTCAGCTGCTAAGAGGCCAGAGGAGGGGTTTTTAGACTTCTGGTCAATATGGCAGAGTAAACACTTGCTGAAAATCCTTAGGCCTCTGCAACATACAGAAATAACAGATACACTA
GAGATGAGATTTGGGCAGACCCAAACCCTATCACAGCTCAAATGGCCTGGTTGAGTCAAAAGGCAACAAAATCAAGTCTGACCTCCAGATGAGATCCACTAGGCATTCCCCATAGATTTGCCACTTAAAAGTGCCCTTGTACTATAC	GAGATGAGATTTGGGCAGACCCAAACCCTATCACAGCTCAAATGGCCTGGTTGAGTCAAAAGGCAACAAAATGAAGTCTGACCTCCAGATGAGATCCACTAGGCATTCCCCATAGATTTGCCACTTAAAAGTGCCCTTGTACTATAC
TTCCTTCCATTTATGTTCTCTAGAGTCTGTTTTCATTGCTGACACCTAAGGTGGTGCATAATTATAAGCCAGTGTGATTTCATTTCCTATCTGAAGCCTTCGAAAAAAATGGCTCTCAAGCAGTATCTCAGACACCCAAATCCAAGG	TTCCTTCCATTTATGTTCTCTAGAGTCTGTTTTCATTGCTGACACCTAAGGTGGTGCATAATTATAAGCCAGCGTGATTTCATTTCCTATCTGAAGCCTTCGAAAAAAATGGCTCTCAAGCAGTATCTCAGACACCCAAATCCAAGG
AGACTTTATTTGTGGCCCTTGTGGCAGTTGATACTTTTTCAGGAAATACTATAGTTGCAGCAGGCCCTGTTATAGCTTAGTGGATATTCATGTTGTGGATGCTTTTTTACCGAAACACACAGTAACCAAGTATCCAGGAGCGGGAGC	AGACTTTATTTGTGGCCCTTGTGGCAGTTGATACTTTTTCAGGAAATACTATAGTTGCAGCAGGCCCTGTTACAGCTTAGTGGATATTCATGTTGTGGATGCTTTTTTACCGAAACACACAGTAACCAAGTATCCAGGAGCGGGAGC
AATGATATGAAATGAAATCAATGTACATAAAAAATAGTCCCTAGTAATAGAAATCAGAAAGTAGTTGCCTAGGGGAAGGAGACATTGACTGGAAAGAAAAAAATGAAGGATTATTCTGGG